lemma	homonym	sem
$	SYM	currency
$A	NOUN	currency
$NZ	NOUN	currency
A/S	NOUN	org
AA	NOUN	org
ADP	NOUN	currency
ADT	NOUN	org
AED	NOUN	currency
AFA	NOUN	currency
AFN	NOUN	currency
ALK	NOUN	currency
ALL	NOUN	currency
AMD	PROPN	org
ANG	NOUN	currency
AOA	NOUN	currency|title
AOK	NOUN	currency
AON	NOUN	currency
AOR	NOUN	currency
ARA	PROPN	currency
ARL	NOUN	currency
ARM	PROPN	currency
ARP	NOUN	currency
ARS	NOUN	currency
AS	NOUN	org
ASA	NOUN	org
ATS	NOUN	currency
AU$	NOUN	currency
AU	PROPN	measure
AUD	NOUN	currency
AUK	NOUN	org
AVI	NOUN	org
AWG	NOUN	currency
AZM	NOUN	currency
AZN	NOUN	currency
Aada	PROPN	female
Aadolf	PROPN	male
Aake	PROPN	male
Aamu	PROPN	female
Aamulehti	PROPN	media
Aamuposti	PROPN	media
Aapeli	PROPN	male
Aapo	PROPN	male
Aappo	PROPN	male
Aaretti	PROPN	male
Aarne	PROPN	male
Aarni	PROPN	male
Aarno	PROPN	male
Aaro	PROPN	male
Aaron	PROPN	male
Aarre	PROPN	male
Aarto	PROPN	male
Aatami	PROPN	male
Aati	PROPN	male
Aatos	PROPN	male
Aatto	PROPN	male
Aatu	PROPN	male
Aava	PROPN	female
Abdel	PROPN	male
Abdul	PROPN	male
Abdullah	PROPN	male
Abel	PROPN	male
Abiel	PROPN	male
Abraham	PROPN	male
Ada	PROPN	female
Adam	PROPN	male
Adele	PROPN	female
Adolf	PROPN	male
Adrian	PROPN	male
Adéle	PROPN	female
Af	NOUN	currency
Afganistan	PROPN	country
Agata	PROPN	female
Agda	PROPN	female
Agnes	PROPN	female
Agneta	PROPN	female
Ah	NOUN	measure
Ahti	PROPN	male
Ahto	PROPN	male
Ahvo	PROPN	male
Aida	PROPN	female
Aija	PROPN	female
Aila	PROPN	female
Aili	PROPN	female
Ailiina	PROPN	female
Aimo	PROPN	male
Aina	PROPN	female
Ainamo	PROPN	female
Aini	PROPN	female
Ainikki	PROPN	female
Aino	PROPN	female
Aino-Linnea	PROPN	female
Aino-Maria	PROPN	female
Aira	PROPN	female
Airi	PROPN	female
Aki	PROPN	male
Akseli	PROPN	male
Aku	PROPN	male
Akusti	PROPN	male
Alan	PROPN	male
Alankomaat	PROPN	country
Alarik	PROPN	male
Alasatakunta	PROPN	media
Albania	PROPN	country
Albert	PROPN	male
Albertina	PROPN	female
Alberto	PROPN	male
Albin	PROPN	male
Ale	PROPN	male
Alec	PROPN	male
Aleksander	PROPN	male
Aleksandra	PROPN	female
Aleksanteri	PROPN	male
Aleksi	PROPN	male
Aleksiina	PROPN	female
Aleksis	PROPN	male
Aleksius	PROPN	male
Alex	PROPN	male
Alexander	PROPN	male
Alexandra	PROPN	female
Alexis	PROPN	male
Aleyna	PROPN	female
Alf	PROPN	male
Alfa	PROPN	female
Alfhild	PROPN	female
Alfons	PROPN	male
Alfred	PROPN	male
Algeria	PROPN	country
Algot	PROPN	male
Ali	PROPN	male
Alice	PROPN	female
Alicia	PROPN	female
Aliina	PROPN	female
Aliisa	PROPN	female
Alina	PROPN	female
Alisa	PROPN	female
Allan	PROPN	male
Alli	PROPN	female
Alma	PROPN	female
Alpi	PROPN	male
Alpo	PROPN	male
Altti	PROPN	male
Alva	PROPN	female
Alvar	PROPN	male
Alveri	PROPN	male
Alvi	PROPN	male
Alvin	PROPN	male
Alvina	PROPN	female
Amalia	PROPN	female
Amanda	PROPN	female
Amelia	PROPN	female
Amelie	PROPN	female
Amilda	PROPN	female
Amira	PROPN	female
Amy	PROPN	female
Anastasia	PROPN	female
Anatolius	PROPN	male
Anders	PROPN	male
Andorra	PROPN	country
Andrea	PROPN	female
Andreas	PROPN	male
Andreevits	PROPN	male
Andrew	PROPN	male
André	PROPN	male
Anelma	PROPN	female
Anette	PROPN	female
Angel	PROPN	female
Angela	PROPN	female
Angelika	PROPN	female
Angelina	PROPN	female
Angelino	PROPN	male
Angola	PROPN	country
Anguilla	PROPN	country
Anissa	PROPN	female
Anita	PROPN	female
Anitta	PROPN	female
Anja	PROPN	female
Ann-Christin	PROPN	female
Ann-Christine	PROPN	female
Ann-Maria	PROPN	female
Anna	PROPN	female
Anna-Eriikka	PROPN	female
Anna-Kaarina	PROPN	female
Anna-Kaisa	PROPN	female
Anna-Liisa	PROPN	female
Anna-Lotta	PROPN	female
Anna-Mari	PROPN	female
Anna-Maria	PROPN	female
Anna-Reeta	PROPN	female
Anna-Sofia	PROPN	female
Anna-Stiina	PROPN	female
Anne	PROPN	female
Anne-Maarit	PROPN	female
Anne-Mari	PROPN	female
Anne-Maria	PROPN	female
Annele	PROPN	female
Anneli	PROPN	female
Annette	PROPN	female
Anni	PROPN	female
Anni-Ilona	PROPN	female
Anniina	PROPN	female
Annika	PROPN	female
Annikki	PROPN	female
Annilotta	PROPN	female
Annina	PROPN	female
Annu	PROPN	female
Annukka	PROPN	female
Annuriikka	PROPN	female
Ano	PROPN	male
Anri	PROPN	female
Ansa	PROPN	female
Anselmi	PROPN	male
Anssi	PROPN	male
Antarktis	PROPN	country
Ante	PROPN	male
Antero	PROPN	male
Anthony	PROPN	male
Antigua	PROPN	country
Anton	PROPN	male
Antoni	PROPN	male
Antonia	PROPN	female
Antonio	PROPN	male
Antti	PROPN	male
Antto	PROPN	male
Antton	PROPN	male
Anttoni	PROPN	male
Anu	PROPN	female
April	PROPN	female
Arabiemiirikunnat	PROPN	country
Arabiemiraatit	PROPN	country
Arbetarbladet	PROPN	media
Arg$	NOUN	currency
Argentiina	PROPN	country
Arhippa	PROPN	male
Arho	PROPN	male
Ari	PROPN	male
Ari-Pekka	PROPN	male
Ariela	PROPN	female
Arja	PROPN	female
Arla	PROPN	female
Armas	PROPN	male
Armenia	PROPN	country
Armi	PROPN	female
Arna	PROPN	female
Arne	PROPN	male
Arno	PROPN	male
Arnold	PROPN	male
Aron	PROPN	male
Arsi	PROPN	male
Arthur	PROPN	male
Arto	PROPN	male
Artti	PROPN	male
Arttu	PROPN	male
Arttu-Elmeri	PROPN	male
Artturi	PROPN	male
Artur	PROPN	male
Aruba	PROPN	country
Arvi	PROPN	male
Arvid	PROPN	male
Arvo	PROPN	male
Ash	PROPN	male
Ashton	PROPN	male
Asko	PROPN	male
Aslak	PROPN	male
Aslög	PROPN	female
Asmo	PROPN	male
Asser	PROPN	male
Assi	PROPN	female
Asta	PROPN	female
Astrid	PROPN	female
Atle	PROPN	male
Atro	PROPN	male
Atso	PROPN	male
Atte	PROPN	male
August	PROPN	male
Augusta	PROPN	female
Augusti	PROPN	male
Augustinus	PROPN	male
Aukusti	PROPN	male
Auli	PROPN	female
Aulikki	PROPN	female
Aulis	PROPN	male
Aune	PROPN	female
Auni	PROPN	female
Auni-Leila	PROPN	female
Auno	PROPN	male
Aura	PROPN	female
Aurelia	PROPN	female
Auri	PROPN	female
Auroora	PROPN	female
Aurora	PROPN	female
Australia	PROPN	country
Auvo	PROPN	male
Axel	PROPN	male
Azerbaidžan	PROPN	country
B	NOUN	measure
B.A.	NOUN	title
B.S.	NOUN	title
B.Sc.	NOUN	title
BA	NOUN	title
BAD	NOUN	currency
BAM	NOUN	currency
BAN	NOUN	currency
BBD	NOUN	currency
BD	NOUN	currency
BDS$	NOUN	currency
BDT	NOUN	currency
BEC	NOUN	currency
BEF	NOUN	currency
BEL	NOUN	currency
BF	NOUN	currency
BGL	NOUN	currency
BGM	NOUN	currency
BGN	NOUN	currency
BGO	NOUN	currency
BHD	NOUN	currency
BIF	NOUN	currency
BMD	NOUN	currency
BND	NOUN	currency
BOB	NOUN	currency
BOL	NOUN	currency
BOP	NOUN	currency
BOV	NOUN	currency
BRB	NOUN	currency
BRC	NOUN	currency
BRE	NOUN	currency
BRL	NOUN	currency
BRN	NOUN	currency
BRR	NOUN	currency
BRZ	NOUN	currency
BSD	NOUN	currency
BSc	NOUN	title
BTN	NOUN	currency
BUK	NOUN	currency
BWP	NOUN	currency
BYB	NOUN	currency
BYR	NOUN	currency
BZ$	NOUN	currency
BZD	NOUN	currency
Bahama	PROPN	country
Bahrain	PROPN	country
Bailey	PROPN	male
Bangladesh	PROPN	country
Barbados	PROPN	country
Barbara	PROPN	female
Barbro	PROPN	female
Barbuda	PROPN	country
Barnaby	PROPN	male
Be	NOUN	currency
Beata	PROPN	female
Beatrice	PROPN	female
Beatrix	PROPN	female
Beeda	PROPN	female
Belau	PROPN	country
Belgia	PROPN	country
Belinda	PROPN	female
Belize	PROPN	country
Bella	PROPN	female
Ben	PROPN	male
Bengt	PROPN	male
Bengta	PROPN	female
Benin	PROPN	country
Benita	PROPN	female
Benjam	PROPN	male
Benjami	PROPN	male
Benjamin	PROPN	male
Benny	PROPN	male
Ber$	NOUN	currency
Berit	PROPN	female
Bermuda	PROPN	country
Bernard	PROPN	male
Bernd	PROPN	male
Bernhard	PROPN	male
Bernice	PROPN	female
Bernt	PROPN	male
Berta	PROPN	female
Bertel	PROPN	male
Bertil	PROPN	male
Bettina	PROPN	female
Bhutan	PROPN	country
Bill	PROPN	male
Birger	PROPN	male
Birgit	PROPN	female
Birgitta	PROPN	female
Bjarne	PROPN	male
Björn	PROPN	male
Bo	PROPN	male
Bob	PROPN	male
Bodil	PROPN	female
Bolivia	PROPN	country
Borgåbladet	PROPN	media
Boris	PROPN	male
Bosnia	PROPN	country
Botswana	PROPN	country
Bouvet’nsaari	PROPN	country
Bq	NOUN	measure
Br	NOUN	currency
Brady	PROPN	male
Brasilia	PROPN	country
Brigitte	PROPN	female
Briitta	PROPN	female
Brita	PROPN	female
Britannia	PROPN	country
Britt	PROPN	female
Britta	PROPN	female
Brooklyn	PROPN	female
Bror	PROPN	male
Brunei	PROPN	country
Bruno	PROPN	male
Brynolf	PROPN	male
Bryson	PROPN	male
Bs	NOUN	currency
Bulgaria	PROPN	country
Burkina	PROPN	country
Burma	PROPN	country
Burundi	PROPN	country
Börje	PROPN	male
C	NOUN	currency|measure
CA$	NOUN	currency
CAD	NOUN	currency
CDF	NOUN	currency
CF	NOUN	currency
CFPF	NOUN	currency
CHE	NOUN	currency
CHF	NOUN	currency
CHW	NOUN	currency
CLE	NOUN	currency
CLF	NOUN	currency
CLP	NOUN	currency
CNX	NOUN	currency
CNY	NOUN	currency
COP	NOUN	currency
COU	NOUN	currency
CR	NOUN	currency
CRC	NOUN	currency
CSD	NOUN	currency
CSK	NOUN	currency
CUC	NOUN	currency
CUP	NOUN	currency
CVE	NOUN	currency
CVEsc	NOUN	currency
CYP	NOUN	currency
CZK	NOUN	currency
Caj	PROPN	male
Camilla	PROPN	female
Can$	NOUN	currency
Cara	PROPN	female
Caramia	PROPN	female
Carina	PROPN	female
Carita	PROPN	female
Carl-Henrik	PROPN	male
Carl-Johan	PROPN	male
Carla	PROPN	female
Carles	PROPN	male
Carlo	PROPN	male
Carola	PROPN	female
Carolina	PROPN	female
Caspian	PROPN	male
Cassandra	PROPN	female
Caymansaaret	PROPN	country
Cecilia	PROPN	female
Celeste	PROPN	female
Celina	PROPN	female
Ch$	NOUN	currency
Charles	PROPN	male
Charlie	PROPN	male
Charlotta	PROPN	female
Chelsea	PROPN	female
Chile	PROPN	country
Chris	PROPN	male
Christa	PROPN	female
Christel	PROPN	female
Christer	PROPN	male
Christian	PROPN	male
Christina	PROPN	female
Christine	PROPN	female
Christoff	PROPN	male
Christoffer	PROPN	male
Christopher	PROPN	male
Clara	PROPN	female
Clark	PROPN	male
Claude	PROPN	male
Claudia	PROPN	female
Clive	PROPN	male
Co	NOUN	org
Co.	NOUN	org
Col$	NOUN	currency
Cole	PROPN	male
Conny	PROPN	male
Conor	PROPN	male
Cookinsaaret	PROPN	country
Cornelia	PROPN	female
Corp	NOUN	org
Corp.	NOUN	org
Crista	PROPN	female
Curaçao	PROPN	country
DA	NOUN	currency
DDM	NOUN	currency
DE	NOUN	title
DEM	NOUN	currency
DF	NOUN	currency
DI	NOUN	title
DJF	NOUN	currency
DKK	NOUN	currency|title
DKr	NOUN	currency
DNA	PROPN	media
DOP	NOUN	currency
DPA	NOUN	media
DU	NOUN	title
DZD	NOUN	currency
Daavid	PROPN	male
Dag	PROPN	male
Daga	PROPN	female
Dagmar	PROPN	female
Dagny	PROPN	female
Dan	PROPN	male
Dani	PROPN	male
Daniel	PROPN	male
Daniela	PROPN	female
Daphne	PROPN	female
Darren	PROPN	male
Dave	PROPN	male
David	PROPN	male
Dawn	PROPN	female
Db	NOUN	currency
Debora	PROPN	female
Denis	PROPN	male
Deniz	PROPN	male
Dennis	PROPN	male
Devon	PROPN	male
Diana	PROPN	female
Dick	PROPN	male
Dieter	PROPN	male
Dimitri	PROPN	male
Dion	PROPN	male
Disa	PROPN	female
Djibouti	PROPN	country
Dolly	PROPN	female
Dominic	PROPN	male
Dominica	PROPN	country
Dominik	PROPN	male
Don	PROPN	male
Donald	PROPN	male
Dora	PROPN	female
Doris	PROPN	female
Dorotea	PROPN	female
Dorrit	PROPN	female
Douglas	PROPN	male
Dr.	NOUN	title
Drew	PROPN	male
E	NOUN	currency
EA	PROPN	measure
EBq	NOUN	measure
EC$	NOUN	currency
EC	NOUN	measure
ECS	NOUN	currency
ECU	NOUN	currency
ECV	NOUN	currency
EEK	NOUN	currency
EF	NOUN	measure
EGP	NOUN	currency
EH	NOUN	measure
EHz	NOUN	measure
EJ	NOUN	measure
EK	PROPN	measure
EL	PROPN	title
ELK	NOUN	title
ELL	NOUN	title
ELT	NOUN	title
ELTO	NOUN	title
EN	PROPN	measure
EOA	NOUN	org
EOAK	NOUN	org
EPa	NOUN	measure
ERN	NOUN	currency
ESA	PROPN	currency
ESB	NOUN	currency
ESP	NOUN	currency
ET	NOUN	measure
ETB	NOUN	currency
ETK	NOUN	title
ETL	NOUN	title
ETM	NOUN	title
EUR	NOUN	currency
EV	NOUN	measure
EW	NOUN	measure
EWb	NOUN	measure
Ea	PROPN	female
Ebba	PROPN	female
Ebbe	PROPN	male
Ecd	NOUN	measure
Ecuador	PROPN	country
Ed	PROPN	male
Edgar	PROPN	male
Edit	PROPN	female
Edouard	PROPN	male
Eduard	PROPN	male
Edvard	PROPN	male
Edvin	PROPN	male
Edward	PROPN	male
Eedit	PROPN	female
Eedla	PROPN	female
Eeli	PROPN	male
Eelis	PROPN	male
Eemeli	PROPN	male
Eemi	PROPN	male
Eemil	PROPN	male
Eerik	PROPN	male
Eerika	PROPN	female
Eerikki	PROPN	male
Eero	PROPN	male
Eesti	PROPN	country
Eetu	PROPN	male
Eeva	PROPN	female
Eevastiina	PROPN	female
Eevert	PROPN	male
Eevertti	PROPN	male
Eevi	PROPN	female
Eg	NOUN	measure
Egil	PROPN	male
Egypti	PROPN	country
Eija	PROPN	female
Eijariina	PROPN	female
Eikka	PROPN	male
Eila	PROPN	female
Einar	PROPN	male
Einari	PROPN	male
Eine	PROPN	female
Eini	PROPN	female
Eino	PROPN	male
Eira	PROPN	female
Eirik	PROPN	male
Eivor	PROPN	female
Ejvind	PROPN	male
Ekat	NOUN	measure
Ekku	PROPN	male
Elea	PROPN	female
Elena	PROPN	female
Eleonoora	PROPN	female
Eleonora	PROPN	female
Elia	PROPN	male
Elias	PROPN	male
Elida	PROPN	female
Eliel	PROPN	male
Eliina	PROPN	female
Eliisa	PROPN	female
Elijah	PROPN	male
Elin	PROPN	female
Elina	PROPN	female
Elis	PROPN	male
Elisa	PROPN	female
Elisabet	PROPN	female
Elisabeth	PROPN	female
Elise	PROPN	female
Elizabeth	PROPN	female
Elja	PROPN	male
Eljas	PROPN	male
Ella	PROPN	female
Ella-Maria	PROPN	female
Ellen	PROPN	female
Elli	PROPN	female
Elli-Noora	PROPN	female
Elliida	PROPN	female
Ellinoora	PROPN	female
Ellinor	PROPN	female
Elliot	PROPN	male
Elm	NOUN	measure
Elma	PROPN	female
Elmer	PROPN	male
Elmeri	PROPN	male
Elmi	PROPN	female
Elmo	PROPN	male
Elna	PROPN	female
Elof	PROPN	male
Elsa	PROPN	female
Elsa-Sofia	PROPN	female
Else	PROPN	female
Elsi	PROPN	female
Elvi	PROPN	female
Elviina	PROPN	female
Elviira	PROPN	female
Elvira	PROPN	female
Elx	NOUN	measure
Em	NOUN	measure
Emanuel	PROPN	male
Emelie	PROPN	female
Emil	PROPN	male
Emili	PROPN	female
Emilia	PROPN	female
Emily	PROPN	female
Emiraatit	PROPN	country
Emma	PROPN	female
Emma-Liina	PROPN	female
Emma-Maria	PROPN	female
Emmaliina	PROPN	female
Emmanuel	PROPN	male
Emmi	PROPN	female
Emmi-Julia	PROPN	female
Emol	NOUN	measure
Enar	PROPN	male
Engelbert	PROPN	male
Engelbrekt	PROPN	male
Enna	PROPN	female
Enni	PROPN	female
Ennika	PROPN	female
Ennina	PROPN	female
Ensio	PROPN	male
Erad	NOUN	measure
Eric	PROPN	male
Erica	PROPN	female
Eriika	PROPN	female
Erik	PROPN	male
Erika	PROPN	female
Erin	PROPN	female
Eritrea	PROPN	country
Erja	PROPN	female
Erjaleena	PROPN	female
Erkka	PROPN	male
Erkki	PROPN	male
Erkko	PROPN	male
Erland	PROPN	male
Erna	PROPN	female
Ernesti	PROPN	male
Erno	PROPN	male
Ernst	PROPN	male
Es	PROPN	measure
Esa	PROPN	male
Esaias	PROPN	male
Eskil	PROPN	male
Esko	PROPN	male
Espanja	PROPN	country
Esr	NOUN	measure
Essi	PROPN	female
Ester	PROPN	female
Esteri	PROPN	female
Esther	PROPN	female
Estrid	PROPN	female
Etel	PROPN	female
Etelä-Afrikka	PROPN	country
Etelä-Georgia	PROPN	country
Etelä-Korea	PROPN	country
Etelä-Saimaa	PROPN	media
Etelä-Sudan	PROPN	country
Etiopia	PROPN	country
Etta	PROPN	female
Eugen	PROPN	male
Eugenia	PROPN	female
Eva	PROPN	female
Evald	PROPN	male
Evamaria	PROPN	female
Eveliina	PROPN	female
Evelina	PROPN	female
Evert	PROPN	male
Evilda	PROPN	female
E°C	NOUN	measure
EΩ	NOUN	measure
F$	NOUN	currency
F	NOUN	measure
FIM	NOUN	currency
FJD	NOUN	currency
FK	NOUN	title
FKP	NOUN	currency
FL	NOUN	title
FM	NOUN	title
FRF	NOUN	currency
FT	NOUN	title
FaK	NOUN	title
FaL	NOUN	title
FaM	NOUN	title
FaT	NOUN	title
Fabian	PROPN	male
Fabrice	PROPN	male
Falklandinsaaret	PROPN	country
Falklandsaaret	PROPN	country
Fanni	PROPN	female
Fanny	PROPN	female
Fanny-Sofia	PROPN	female
Faní	PROPN	female
Fbu	NOUN	currency
Felicia	PROPN	female
Felix	PROPN	male
Ferdinand	PROPN	male
Fernandez	PROPN	male
Fernando	PROPN	male
Fidelma	PROPN	female
Fidži	PROPN	country
Fiia	PROPN	female
Filip	PROPN	male
Filippa	PROPN	female
Filippiinit	PROPN	country
Finn	PROPN	male
Fiona	PROPN	female
Fjalar	PROPN	male
Floora	PROPN	female
Flora	PROPN	female
Folke	PROPN	male
Frances	PROPN	male
Franco	PROPN	male
Frank	PROPN	male
Frans	PROPN	male
Fransiska	PROPN	female
François	PROPN	male
Fred	PROPN	male
Frederic	PROPN	male
Fredrik	PROPN	male
Fredrika	PROPN	female
Frej	PROPN	male
Freja	PROPN	female
Frejvid	PROPN	male
Frida	PROPN	female
Fridolf	PROPN	male
Friedrich	PROPN	male
Fritiof	PROPN	male
Fritjof	PROPN	male
Ft	NOUN	currency
Färsaaret	PROPN	country
G$	NOUN	currency
G	PROPN	currency
GA	NOUN	measure
GBP	NOUN	currency
GBq	NOUN	measure
GC	NOUN	measure
GEK	NOUN	currency
GEL	NOUN	currency
GF	NOUN	currency|measure
GH	NOUN	measure
GHC	NOUN	currency
GHS	NOUN	currency
GHz	NOUN	measure
GIP	NOUN	currency
GJ	NOUN	measure
GK	NOUN	measure
GMD	NOUN	currency
GN	NOUN	measure
GNF	NOUN	currency
GNS	NOUN	currency
GPa	NOUN	measure
GQE	NOUN	currency
GRD	NOUN	currency
GS	NOUN	measure
GT	NOUN	measure
GTQ	NOUN	currency
GV	NOUN	measure
GW	NOUN	measure
GWE	NOUN	currency
GWP	NOUN	currency
GWb	NOUN	measure
GYD	NOUN	currency
Gabon	PROPN	country
Gabriel	PROPN	male
Gambia	PROPN	country
Gary	PROPN	male
Gcd	NOUN	measure
Geir	PROPN	male
Georg	PROPN	male
George	PROPN	male
Georgia	PROPN	female
Gerald	PROPN	male
Gerhard	PROPN	male
Germund	PROPN	male
Gerry	PROPN	male
Gert	PROPN	male
Gg	NOUN	measure
Ghana	PROPN	country
Gianluigi	PROPN	male
Gibraltar	PROPN	country
Gina	PROPN	female
Giuseppe	PROPN	male
Gkat	NOUN	measure
Glenn	PROPN	male
Glm	NOUN	measure
Glx	NOUN	measure
Gm	NOUN	measure
GmbH	NOUN	org
Gmbh	NOUN	org
Gmol	NOUN	measure
Gottfrid	PROPN	male
Grace	PROPN	female
Grad	NOUN	measure
Graham	PROPN	male
Greger	PROPN	male
Gregorius	PROPN	male
Grels	PROPN	male
Grenada	PROPN	country
Grenadiinit	PROPN	country
Gruusia	PROPN	country
Grönlanti	PROPN	country
Gs	NOUN	measure
Gsr	NOUN	measure
Guadeloupe	PROPN	country
Guam	PROPN	country
Guatemala	PROPN	country
Gudmund	PROPN	male
Guinea	PROPN	country
Guinea-Bissau	PROPN	country
Gunnar	PROPN	male
Gustav	PROPN	male
Guy	PROPN	male
Guyana	PROPN	country
Gy	NOUN	measure
G°C	NOUN	measure
Göran	PROPN	male
Gösta	PROPN	male
Göte	PROPN	male
Günter	PROPN	male
GΩ	NOUN	measure
HA	NOUN	title
HAO	NOUN	org
HK$	NOUN	currency
HK	PROPN	title
HKD	NOUN	currency
HL	NOUN	title
HL	PROPN	title
HLK	NOUN	title
HLL	NOUN	title
HLT	NOUN	title
HM	NOUN	title
HN	NOUN	title
HNL	NOUN	currency
HO	PROPN	org
HOK	NOUN	title
HRD	NOUN	currency
HRK	NOUN	currency
HT	PROPN	title
HTG	NOUN	currency
HTK	NOUN	title
HTL	NOUN	title
HTM	NOUN	title
HTT	NOUN	title
HUF	NOUN	currency
Hagar	PROPN	female
Haiti	PROPN	country
Haley	PROPN	male
Halvar	PROPN	male
Hampus	PROPN	male
Hanna	PROPN	female
Hanna-Emilia	PROPN	female
Hanna-Kaisa	PROPN	female
Hanna-Kristiina	PROPN	female
Hanna-Leena	PROPN	female
Hanna-Maija	PROPN	female
Hanna-Maria	PROPN	female
Hanna-Riikka	PROPN	female
Hannah	PROPN	female
Hannamari	PROPN	female
Hannamaria	PROPN	female
Hanne	PROPN	female
Hannele	PROPN	female
Hannes	PROPN	male
Hanni	PROPN	female
Hannu	PROPN	male
Hannuntytär	PROPN	female
Hans	PROPN	male
Harald	PROPN	male
Harri	PROPN	male
Harriet	PROPN	female
Harry	PROPN	male
Heather	PROPN	female
Hedda	PROPN	female
Hedvig	PROPN	female
Heidi	PROPN	female
Heidi-Kaarina	PROPN	female
Heidi-Maria	PROPN	female
Heikki	PROPN	male
Heimo	PROPN	male
Heini	PROPN	female
Heini-Ilona	PROPN	female
Heino	PROPN	male
Heinrich	PROPN	male
Helen	PROPN	female
Helena	PROPN	female
Helga	PROPN	female
Helge	PROPN	male
Heli	PROPN	female
Heli-Johanna	PROPN	female
Helinä	PROPN	female
Heljä	PROPN	female
Helka	PROPN	female
Helle	PROPN	female
Hellen	PROPN	female
Hellevi	PROPN	female
Helli	PROPN	female
Hellin	PROPN	female
Hellä	PROPN	female
Helmer	PROPN	male
Helmi	PROPN	female
Helmi-Kristina	PROPN	female
Helmiina	PROPN	female
Helvi	PROPN	female
Helvig	PROPN	female
Hely	PROPN	female
Hemmi	PROPN	male
Hemming	PROPN	male
Hemminki	PROPN	male
Hemmo	PROPN	male
Henna	PROPN	female
Henna-Erika	PROPN	female
Hennariikka	PROPN	female
Henni	PROPN	female
Henniina	PROPN	female
Henning	PROPN	male
Henri	PROPN	male
Henrietta	PROPN	female
Henriette	PROPN	female
Henriikka	PROPN	female
Henrik	PROPN	male
Henrika	PROPN	female
Henrikki	PROPN	male
Henry	PROPN	male
Herbert	PROPN	male
Herkko	PROPN	male
Herman	PROPN	male
Hermanni	PROPN	male
Hertsegovina	PROPN	country
Hertta	PROPN	female
Heta	PROPN	female
Heta-Johanna	PROPN	female
Heta-Liisa	PROPN	female
Hevosurheilu	PROPN	media
Hiisi	PROPN	male
Hilda	PROPN	female
Hildegard	PROPN	female
Hildegerd	PROPN	female
Hilding	PROPN	male
Hildur	PROPN	female
Hilja	PROPN	female
Hilkka	PROPN	female
Hilla	PROPN	female
Hillary	PROPN	female
Hille	PROPN	female
Hillevi	PROPN	female
Hilma	PROPN	female
Hilppa	PROPN	female
Hjalmar	PROPN	male
Hjördis	PROPN	female
Holger	PROPN	male
Hollanti	PROPN	country
Honduras	PROPN	country
Hongkong	PROPN	country
HuK	NOUN	title
Hufvudstadsbladet	PROPN	media
Hugh	PROPN	male
Hugo	PROPN	male
Huippuvuoret	PROPN	country
Hulda	PROPN	female
Hz	NOUN	measure
Håkan	PROPN	male
ID	NOUN	currency
IDR	NOUN	currency
IEP	NOUN	currency
ILP	NOUN	currency
ILR	NOUN	currency
ILS	NOUN	currency
INR	NOUN	currency
IQD	NOUN	currency
IRR	NOUN	currency
IR£	NOUN	currency
ISJ	NOUN	currency
ISK	NOUN	currency
ITL	NOUN	currency
IU	NOUN	measure
Ian	PROPN	male
Ibrahim	PROPN	male
Ida	PROPN	female
Ida-Jemina	PROPN	female
Ida-Maria	PROPN	female
Iia	PROPN	female
Iida	PROPN	female
Iida-Olivia	PROPN	female
Iida-Reetta	PROPN	female
Iijokiseutu	PROPN	media
Iikka	PROPN	male
Iina	PROPN	female
Iina-Liisa	PROPN	female
Iines	PROPN	female
Iiris	PROPN	female
Iiro	PROPN	male
Iisakki	PROPN	male
Iita	PROPN	female
Iitinseutu	PROPN	media
Iivari	PROPN	male
Iivo	PROPN	male
Ilari	PROPN	male
Ilja	PROPN	male
Ilkanpoika	PROPN	male
Ilkka	PROPN	male
Illusia	PROPN	female
Ilma	PROPN	female
Ilmari	PROPN	male
Ilmarinen	PROPN	male
Ilmatar	PROPN	female
Ilmi	PROPN	female
Ilmo	PROPN	male
Ilona	PROPN	female
Ilpo	PROPN	male
Ilppo	PROPN	male
Ilse	PROPN	female
Ilta	PROPN	female
Ilta-Sanomat	PROPN	media
Iltalehti	PROPN	media
Immanuel	PROPN	male
Immi	PROPN	female
Immo	PROPN	male
Impi	PROPN	female
Ina	PROPN	female
Inari	PROPN	female
Indiana	PROPN	female
Indonesia	PROPN	country
Ines	PROPN	female
Inga	PROPN	female
Ingalill	PROPN	female
Inge	PROPN	male
Ingeborg	PROPN	female
Ingegerd	PROPN	female
Ingela	PROPN	female
Ingemar	PROPN	male
Inger	PROPN	female
Ingmar	PROPN	male
Ingolf	PROPN	male
Ingrid	PROPN	female
Ingvald	PROPN	male
Ingvar	PROPN	male
Inka	PROPN	female
Inka-Julia	PROPN	female
Inkeri	PROPN	female
Inna	PROPN	female
Intia	PROPN	country
Into	PROPN	male
Ira	PROPN	female
Irak	PROPN	country
Iran	PROPN	country
Irene	PROPN	female
Irina	PROPN	female
Irinja	PROPN	female
Iris	PROPN	female
Irja	PROPN	female
Irjaliisa	PROPN	female
Irlanti	PROPN	country
Irma	PROPN	female
Irma-Liisa	PROPN	female
Irmeli	PROPN	female
Irmelin	PROPN	female
Iro	PROPN	female
Isa	PROPN	female
Isaac	PROPN	male
Isabella	PROPN	female
Isak	PROPN	male
Isko	PROPN	male
Isla	PROPN	female
Islanti	PROPN	country
Ismo	PROPN	male
Iso-Britannia	PROPN	country
Israel	PROPN	country
Isto	PROPN	male
Italia	PROPN	country
Itä-Häme	PROPN	media
Itä-Savo	PROPN	media
Itä-Timor	PROPN	country
Itävalta	PROPN	country
Ivar	PROPN	male
Izvestija	PROPN	media
J$	NOUN	currency
J	NOUN	measure
JD	NOUN	currency
JHTT	NOUN	org
JMD	NOUN	currency
JOD	NOUN	currency
JP-Kunnallissanomat	PROPN	media
JPY	NOUN	currency
Jaakkima	PROPN	male
Jaakko	PROPN	male
Jaakob	PROPN	male
Jaakoppi	PROPN	male
Jaana	PROPN	female
Jack	PROPN	male
Jacob	PROPN	male
Jade	PROPN	female
Jade-Maria	PROPN	female
Jadessa	PROPN	female
Jael	PROPN	male
Jaime	PROPN	male
Jake	PROPN	male
Jakob	PROPN	male
Jali	PROPN	male
Jalmari	PROPN	male
Jalo	PROPN	male
Jamaika	PROPN	country
James	PROPN	male
Jami	PROPN	male
Jan	PROPN	male
Jane	PROPN	female
Janet	PROPN	female
Janetta	PROPN	female
Janette	PROPN	female
Jani	PROPN	male
Janica	PROPN	female
Janika	PROPN	female
Janina	PROPN	female
Janita	PROPN	female
Janna	PROPN	female
Janna-Mari	PROPN	female
Janne	PROPN	male
Janni	PROPN	female
Jannika	PROPN	female
Japani	PROPN	country
Jari	PROPN	male
Jarkko	PROPN	male
Jarl	PROPN	male
Jarmo	PROPN	male
Jarna	PROPN	female
Jarno	PROPN	male
Jaro	PROPN	male
Jasmiina	PROPN	female
Jasmin	PROPN	female
Jasmine	PROPN	female
Jasper	PROPN	male
Jasperi	PROPN	male
Jasu	PROPN	male
Jatta	PROPN	female
Jean	PROPN	male
Jean-Luc	PROPN	male
Jeanette	PROPN	female
Jeesus	PROPN	male
Jeff	PROPN	male
Jeffrey	PROPN	male
Jemen	PROPN	country
Jemina	PROPN	female
Jenika	PROPN	female
Jenina	PROPN	female
Jenna	PROPN	female
Jenna-Rosa	PROPN	female
Jenni	PROPN	female
Jenni-Marianne	PROPN	female
Jennica	PROPN	female
Jennifer	PROPN	female
Jenniina	PROPN	female
Jennina	PROPN	female
Jenny	PROPN	female
Jens	PROPN	male
Jere	PROPN	male
Jere-Mikael	PROPN	male
Jere-Petteri	PROPN	male
Jeremia	PROPN	male
Jeremias	PROPN	male
Jeremy	PROPN	male
Jerker	PROPN	male
Jermu	PROPN	male
Jesper	PROPN	male
Jesperi	PROPN	male
Jesse	PROPN	male
Jessica	PROPN	female
Jesus	PROPN	male
Jetta	PROPN	female
Jill	PROPN	female
Jim	PROPN	male
Jimi	PROPN	male
Jimmy	PROPN	male
Jiri	PROPN	male
Jirko	PROPN	male
Joachim	PROPN	male
Joakim	PROPN	male
Joanna	PROPN	female
Joanne	PROPN	female
Joel	PROPN	male
Johan	PROPN	male
Johann	PROPN	male
Johanna	PROPN	female
Johanne	PROPN	female
Johannes	PROPN	male
John	PROPN	male
Johnny	PROPN	male
Jomi	PROPN	male
Jon	PROPN	male
Jonas	PROPN	male
Jonatan	PROPN	male
Jonathan	PROPN	male
Jone	PROPN	male
Joni	PROPN	male
Joni-Markku	PROPN	male
Joni-Petteri	PROPN	male
Jonna	PROPN	female
Jonne	PROPN	male
Jonni	PROPN	male
Jony	PROPN	male
Jooa	PROPN	male
Joona	PROPN	male
Joonas	PROPN	male
Joonatan	PROPN	male
Joosef	PROPN	male
Jooseppi	PROPN	male
Joosu	PROPN	male
Jordan	PROPN	male
Jordania	PROPN	country
Jore	PROPN	male
Jori	PROPN	male
Jorma	PROPN	male
Jose	PROPN	male
Josef	PROPN	male
Josefiina	PROPN	female
Josefin	PROPN	female
Josefina	PROPN	female
Josefine	PROPN	female
Josep	PROPN	male
Joseph	PROPN	male
Joshua	PROPN	male
Joukahainen	PROPN	male
Jouko	PROPN	male
Joulusaari	PROPN	country
Jouni	PROPN	male
Jousia	PROPN	male
Joutseno	PROPN	media
Joyce	PROPN	female
Judit	PROPN	female
Judith	PROPN	female
Jugoslavia	PROPN	country
Juha	PROPN	male
Juha-Matti	PROPN	male
Juha-Pekka	PROPN	male
Juha-Petri	PROPN	male
Juhana	PROPN	male
Juhani	PROPN	male
Juho	PROPN	male
Juho-Pekka	PROPN	male
Jukka	PROPN	male
Jukka-Pekka	PROPN	male
Julia	PROPN	female
Juliaana	PROPN	female
Julian	PROPN	male
Juliana	PROPN	female
Julianna	PROPN	female
Julianne	PROPN	female
Julie	PROPN	female
Juliette	PROPN	female
Julius	PROPN	male
Junior	PROPN	male
Junnu	PROPN	male
Juri	PROPN	male
Jusa-Petteri	PROPN	male
Jussa-Pekka	PROPN	male
Jussi	PROPN	male
Jussi-Pekka	PROPN	male
Jussipekka	PROPN	male
Justin	PROPN	male
Justus	PROPN	male
Jusu	PROPN	male
Jutta	PROPN	female
Juttamari	PROPN	female
Juulia	PROPN	female
Juuso	PROPN	male
Jyri	PROPN	male
Jyrki	PROPN	male
Järviseutu	PROPN	media
Jöran	PROPN	male
Jörgen	PROPN	male
Jörn	PROPN	male
Jürgen	PROPN	male
K	NOUN	measure
KAT	NOUN	org
KD	NOUN	currency|polit
KES	NOUN	currency
KGS	NOUN	currency
KHK	NOUN	title
KHO	PROPN	org
KHR	NOUN	currency
KHT	NOUN	title
KK	NOUN	title
KKO	NOUN	org
KL	NOUN	title
KM	NOUN	currency|title
KMF	NOUN	currency
KO	PROPN	org
KOY	NOUN	org
KPW	NOUN	currency
KRH	NOUN	currency
KRO	NOUN	currency
KRP	NOUN	org
KRW	NOUN	currency
KT	NOUN	title
KTK	NOUN	title
KTL	NOUN	title
KTM	NOUN	title
KTT	NOUN	title
KUA	NOUN	org
KWD	NOUN	currency
KYD	NOUN	currency
KZT	NOUN	currency
Kaakonkulma	PROPN	media
Kaapo	PROPN	male
Kaappo	PROPN	male
Kaapro	PROPN	male
Kaariina	PROPN	female
Kaarina	PROPN	female
Kaarle	PROPN	male
Kaarlo	PROPN	male
Kai	PROPN	male
Kai-Jouni	PROPN	male
Kaija	PROPN	female
Kaino	PROPN	female
Kaisa	PROPN	female
Kaisla	PROPN	female
Kaisu	PROPN	female
Kaj	PROPN	male
Kajsa	PROPN	female
Kalajokilaakso	PROPN	media
Kalervi	PROPN	male
Kalervo	PROPN	male
Kaleva	PROPN	male|media
Kalevi	PROPN	male
Kalle	PROPN	male
Kambodža	PROPN	country
Kamerun	PROPN	country
Kanada	PROPN	country
Kanerva	PROPN	female
Kanervo	PROPN	male
Karelia	PROPN	female
Kari	PROPN	male
Karin	PROPN	female
Karita	PROPN	female
Karjalainen	PROPN	media
Karl	PROPN	male
Karla	PROPN	female
Karo	PROPN	male
Karoliina	PROPN	female
Karolina	PROPN	female
Karri	PROPN	male
Karri-Tapio	PROPN	male
Kasimir	PROPN	male
Kasper	PROPN	male
Kasperi	PROPN	male
Kaste	PROPN	female
Kastehelmi	PROPN	female
Katariina	PROPN	female
Katarina	PROPN	female
Katharina	PROPN	female
Kati	PROPN	female
Kati-Maria	PROPN	female
Katinka	PROPN	female
Katja	PROPN	female
Katri	PROPN	female
Katri-Helena	PROPN	female
Katriina	PROPN	female
Katrin	PROPN	female
Katrina	PROPN	female
Katta	PROPN	female
Kauko	PROPN	male
Kauno	PROPN	male
Kauppalehti	PROPN	media
Kauto	PROPN	male
Kazakstan	PROPN	country
Keelingsaaret	PROPN	country
Keijo	PROPN	male
Keimo	PROPN	male
Kelly	PROPN	male
Kenia	PROPN	country
Kennet	PROPN	male
Kent	PROPN	male
Kerkko	PROPN	male
Kerstin	PROPN	female
Kerttu	PROPN	female
Kerttuli	PROPN	female
Kesk.	NOUN	org|polit
Keski-Afrikka	PROPN	country
Keski-Häme	PROPN	media
Keski-Uusimaa	PROPN	media
Keskilaakso	PROPN	media
Keskipohjanmaa	PROPN	media
Keskisuomalainen	PROPN	media
Kettil	PROPN	male
Kevin	PROPN	male
Kia	PROPN	female
Kiamilla	PROPN	female
Kielo	PROPN	female
Kiia	PROPN	female
Kiina	PROPN	country
Kiira	PROPN	female
Kiira-Johanna	PROPN	female
Kim	PROPN	male|female
Kimi	PROPN	male
Kimmo	PROPN	male
Kimsdotter	PROPN	female
Kira	PROPN	female
Kira-Maria	PROPN	female
Kirgisia	PROPN	country
Kirgisistan	PROPN	country
Kirgistan	PROPN	country
Kiribati	PROPN	country
Kirsi	PROPN	female
Kirsi-Maria	PROPN	female
Kirsi-Marie	PROPN	female
Kirsti	PROPN	female
Kiuruvesi	PROPN	media
Kjell	PROPN	male
Klaara	PROPN	female
Klara	PROPN	female
Klas	PROPN	male
Klaus	PROPN	male
Knut	PROPN	male
Koillis-Lappi	PROPN	media
Koillis-Savo	PROPN	media
Koillissanomat	PROPN	media
Kok.	NOUN	org|polit
Kolumbia	PROPN	country
Komiat	PROPN	media
Komorit	PROPN	country
Kongo	PROPN	country
Kongo-Brazzaville	PROPN	country
Kongo-Kinshasa	PROPN	country
Konrad	PROPN	male
Konsta	PROPN	male
Konstantin	PROPN	male
Kookossaaret	PROPN	country
Korea	PROPN	country
Kosovo	PROPN	country
Kosti	PROPN	male
Koti-Karjala	PROPN	media
Kotiseutu-uutiset	PROPN	media
Kreikka	PROPN	country
Krista	PROPN	female
Kristel	PROPN	female
Kristen	PROPN	female
Krister	PROPN	male
Kristian	PROPN	male
Kristiina	PROPN	female
Kristin	PROPN	female
Kristina	PROPN	female
Kristine	PROPN	female
Kristoffer	PROPN	male
Kroatia	PROPN	country
KtaO	NOUN	title
KteO	NOUN	title
KtyO	NOUN	title
Kuhmolainen	PROPN	media
Kuisma	PROPN	male
Kukka	PROPN	female
Kukka-Maaria	PROPN	female
Kullervo	PROPN	male
Kurt	PROPN	male
Kustaa	PROPN	male
Kustavi	PROPN	male
Kuuba	PROPN	country
Kuutonen	PROPN	media
KuvO	NOUN	title
Kuwait	PROPN	country
Kylli	PROPN	female
Kyllikki	PROPN	female
Kypros	PROPN	country
Kyösti	PROPN	male
KäO	NOUN	org
L	NOUN	currency
LAK	NOUN	currency
LBP	NOUN	currency
LD	NOUN	currency
LH	NOUN	org
LK	NOUN	title
LKH	NOUN	org
LKR	NOUN	currency
LKT	NOUN	title
LKV	NOUN	title
LL	NOUN	title|currency
LOK	NOUN	title
LP	NOUN	org
LRD	NOUN	currency
LS	NOUN	currency
LSL	NOUN	currency
LT	PROPN	title
LTL	NOUN	currency
LTO	NOUN	title
LTT	PROPN	currency
LUC	NOUN	currency
LUF	PROPN	currency
LUL	NOUN	currency
LVL	NOUN	currency
LVM	NOUN	org
LVR	NOUN	currency
LYD	NOUN	currency
LaK	NOUN	title
LaL	NOUN	title
LaT	NOUN	title
Lahja	PROPN	female
Laila	PROPN	female
Laina	PROPN	female
Laos	PROPN	country
Lari	PROPN	male
Larissa	PROPN	female
Larry	PROPN	male
Lars	PROPN	male
Lasse	PROPN	male
Lassi	PROPN	male
Lassi-Jussi	PROPN	male
Latvia	PROPN	country
Lauha	PROPN	female
Laukaa-Konnevesi	PROPN	media
Launo	PROPN	male
Laura	PROPN	female
Lauri	PROPN	male
Lauriina	PROPN	female
Laurinpoika	PROPN	male
Lea	PROPN	female
Leander	PROPN	male
Lednova	PROPN	female
Leea	PROPN	female
Leena	PROPN	female
Leena-Maria	PROPN	female
Leeni	PROPN	female
Leevi	PROPN	male
Leif	PROPN	male
Leila	PROPN	female
Lemmikki	PROPN	female
Lemminkäinen	PROPN	male
Lempi	PROPN	female
Lena	PROPN	female
Lenita	PROPN	female
Lennart	PROPN	male
Lenne	PROPN	male
Lenni	PROPN	male
Leo	PROPN	male
Leonard	PROPN	male
Leonardo	PROPN	male
Leonora	PROPN	female
Leopold	PROPN	male
Lesotho	PROPN	country
Lestijoki	PROPN	media
Levin	PROPN	male
LiK	NOUN	title
Lia	PROPN	female
Liam	PROPN	male
Libanon	PROPN	country
Liberia	PROPN	country
Libya	PROPN	country
Liechtenstein	PROPN	country
Liettua	PROPN	country
Liina	PROPN	female
Liina-Maria	PROPN	female
Liisa	PROPN	female
Liisi	PROPN	female
Lila	PROPN	female
Lilian	PROPN	female
Lilja	PROPN	female
Lilla	PROPN	female
Lillemor	PROPN	female
Lilli	PROPN	female
Lilli-Noora	PROPN	female
Lina	PROPN	female
Linda	PROPN	female
Linn	PROPN	female
Linnea	PROPN	female
Linnéa	PROPN	female
Linus	PROPN	male
Lionel	PROPN	male
Lisa	PROPN	female
Lisbet	PROPN	female
Lisen	PROPN	female
LitK	NOUN	title
LitL	NOUN	title
LitM	NOUN	title
LitT	NOUN	title
Liv	PROPN	media
Livia	PROPN	female
Lm	NOUN	currency
Lorentz	PROPN	male
Lotta	PROPN	female
Lotten	PROPN	female
Louis	PROPN	male
Louise	PROPN	female
Loviisa	PROPN	female
Lovisa	PROPN	female
Lp	NOUN	org
LuK	NOUN	title
Luca	PROPN	male
Lucas	PROPN	male
Lucia	PROPN	female
Ludvig	PROPN	male
Ludwig	PROPN	male
Luigi	PROPN	male
Luis	PROPN	male
Luise	PROPN	female
Luka	PROPN	male
Lukas	PROPN	male
Lulu	PROPN	female
Lumi	PROPN	female
Lumia	PROPN	female
Lumina	PROPN	female
Luna	PROPN	female
Luoteisväylä	PROPN	media
Luuka	PROPN	male
Luukas	PROPN	male
Luxemburg	PROPN	country
Lydia	PROPN	female
Lyly	PROPN	male
Lyydia	PROPN	female
Lyyli	PROPN	female
Länsi-Sahara	PROPN	country
Länsi-Savo	PROPN	media
Länsi-Suomi	PROPN	media
Länsi-Uusimaa	PROPN	media
M	NOUN	currency
M.	PROPN	title
M.A.	NOUN	title
M.B.A	NOUN	title
M.Sc.	NOUN	title
MA	NOUN	measure|title
MAD	NOUN	currency
MAF	NOUN	currency
MB	NOUN	measure
MBA	NOUN	title
MBA.	NOUN	title
MBq	NOUN	measure
MC	NOUN	measure
MCF	NOUN	currency
MDC	NOUN	currency
MDL	NOUN	currency
MDen	NOUN	currency
MEP	NOUN	title
MEUR	NOUN	currency
MEX$	NOUN	currency
MF	NOUN	measure
MGA	NOUN	currency
MGF	NOUN	currency
MH	NOUN	measure|title
MHz	NOUN	measure
MI	NOUN	title
MJ	NOUN	measure
MK	NOUN	currency|measure
MKD	NOUN	currency
MKN	NOUN	currency
MLF	NOUN	currency
MMK	NOUN	currency|title
MML	NOUN	title
MMM	NOUN	org|title
MMT	NOUN	title
MN	NOUN	measure
MNT	NOUN	currency
MO	NOUN	title
MOP	NOUN	currency
MPa	NOUN	measure
MRO	NOUN	currency
MS	NOUN	measure
MSc	NOUN	title
MT	NOUN	org
MTI	NOUN	title
MTL	PROPN	currency
MTP	NOUN	currency
MTV3	PROPN	media
MUR	NOUN	currency
MV	NOUN	measure
MVR	NOUN	currency
MW	NOUN	measure
MWK	NOUN	currency
MWb	NOUN	measure
MWh	NOUN	measure
MXN	NOUN	currency
MXP	NOUN	currency
MXV	NOUN	currency
MYR	NOUN	currency
MZE	NOUN	currency
MZM	NOUN	currency
MZN	NOUN	currency
MaO	NOUN	org
Maaret	PROPN	female
Maari	PROPN	female
Maaria	PROPN	female
Maarit	PROPN	female
Maaselkä	PROPN	media
Macao	PROPN	country
Madagaskar	PROPN	country
Madeleine	PROPN	female
Magdalena	PROPN	female
Magna	PROPN	female
Magnhild	PROPN	female
Magnus	PROPN	male
Maia	PROPN	female
Maija	PROPN	female
Maija-Liisa	PROPN	female
Maiju	PROPN	female
Maikki	PROPN	female
Maila	PROPN	female
Maili	PROPN	female
Mailis	PROPN	female
Maini	PROPN	female
Mainio	PROPN	male
Maire	PROPN	female
Maisa	PROPN	female
Maj	PROPN	female
Maja	PROPN	female
Makedonia	PROPN	country
Malawi	PROPN	country
Malcolm	PROPN	male
Malediivit	PROPN	country
Malena	PROPN	female
Malesia	PROPN	country
Mali	PROPN	country
Malin	PROPN	female
Malina	PROPN	female
Malla	PROPN	female
Malta	PROPN	country
Malte	PROPN	male
Malvinassaaret	PROPN	country
Mandi	PROPN	female
Manfred	PROPN	male
Manne	PROPN	male
Mansaari	PROPN	country
Manta	PROPN	female
Manu	PROPN	male
Manuela	PROPN	female
Marc	PROPN	male
Marcel	PROPN	male
Marco	PROPN	male
Marena	PROPN	female
Margareeta	PROPN	female
Margaret	PROPN	female
Margareta	PROPN	female
Margit	PROPN	female
Margita	PROPN	female
Mari	PROPN	female
María	PROPN	female
Maria	PROPN	female
Maria-Kristina	PROPN	female
Marianna	PROPN	female
Marianne	PROPN	female
Marie	PROPN	female
Mariela	PROPN	female
Mariella	PROPN	female
Mariia	PROPN	female
Mariitta	PROPN	female
Marika	PROPN	female
Marilla	PROPN	female
Marimir	PROPN	female
Marina	PROPN	female
Marinka	PROPN	female
Marintytär	PROPN	female
Marit	PROPN	female
Marita	PROPN	female
Maritta	PROPN	female
Marja	PROPN	female
Marja-Leena	PROPN	female
Marja-Liisa	PROPN	female
Marja-Riitta	PROPN	female
Marjaana	PROPN	female
Marjaleena	PROPN	female
Marjaliisa	PROPN	female
Marjatta	PROPN	female
Marjetta	PROPN	female
Marjo	PROPN	female
Marjo-Riitta	PROPN	female
Marjukka	PROPN	female
Marjut	PROPN	female
Mark	PROPN	male
Marketta	PROPN	female
Markku	PROPN	male
Marko	PROPN	male
Markonpoika	PROPN	male
Markus	PROPN	male
Marleena	PROPN	female
Marlene	PROPN	female
Marokko	PROPN	country
Marshallinsaaret	PROPN	country
Marta	PROPN	female
Martin	PROPN	male
Martina	PROPN	female
Martinique	PROPN	country
Martta	PROPN	female
Martti	PROPN	male
Marvin	PROPN	male
Mary	PROPN	female
Mathilde	PROPN	female
Matias	PROPN	male
Matilda	PROPN	female
Matleena	PROPN	female
Mats	PROPN	male
Matthew	PROPN	male
Matthias	PROPN	male
Matti	PROPN	male
Mattias	PROPN	male
Mauno	PROPN	male
Maunu	PROPN	male
Mauri	PROPN	male
Mauritania	PROPN	country
Mauritius	PROPN	country
Mauritz	PROPN	male
Max	PROPN	male
Maximilian	PROPN	male
Maximus	PROPN	male
Mayotte	PROPN	country
Mb	NOUN	measure
Mcd	NOUN	measure
Mea	PROPN	female
Meea	PROPN	female
Meeri	PROPN	female
Meiju	PROPN	female
Meksiko	PROPN	country
Melia	PROPN	female
Melike	PROPN	female
Melina	PROPN	female
Melinda	PROPN	female
Melissa	PROPN	female
Melvin	PROPN	male
Menna	PROPN	female
Mercedes	PROPN	female
Meri	PROPN	female
Meri-Tuulia	PROPN	female
Merit	PROPN	female
Merituuli	PROPN	female
Merja	PROPN	female
Merle	PROPN	female
Mertsi	PROPN	female
Mervi	PROPN	female
Mette	PROPN	female
Mg	NOUN	measure
Mia	PROPN	female
Micaela	PROPN	female
Michael	PROPN	male
Michaela	PROPN	female
Michaelsdotter	PROPN	female
Michelle	PROPN	female
Mick	PROPN	male
Mielikki	PROPN	female
Mies	PROPN	male
Mihka	PROPN	male
Miia	PROPN	female
Miika	PROPN	male
Miika-Matias	PROPN	male
Miikael	PROPN	male
Miikka	PROPN	male
Miikkael	PROPN	male
Miilu	PROPN	media
Miina	PROPN	female
Miisa	PROPN	female
Mika	PROPN	male
Mikael	PROPN	male
Mikaela	PROPN	female
Mike	PROPN	male
Mikke	PROPN	male
Mikko	PROPN	male
Miko	PROPN	male
Mikronesia	PROPN	country
Mila	PROPN	female
Milena	PROPN	female
Mili	PROPN	female
Milja	PROPN	female
Miljaana	PROPN	female
Milka	PROPN	female
Milla	PROPN	female
Milli	PROPN	female
Milo	PROPN	male
Milton	PROPN	male
Mimi	PROPN	female
Mimmi	PROPN	female
Mimmu	PROPN	female
Mimosa	PROPN	female
Minea	PROPN	female
Minella	PROPN	female
Minja	PROPN	female
Minka	PROPN	female
Minna	PROPN	female
Minnea	PROPN	female
Minttu	PROPN	female
Minttu-Maaria	PROPN	female
Miquelon	PROPN	country
Mira	PROPN	female
Miranda	PROPN	female
Miray	PROPN	male
Mireile	PROPN	female
Mirella	PROPN	female
Mirelle	PROPN	female
Miria	PROPN	female
Mirja	PROPN	female
Mirjam	PROPN	female
Mirjami	PROPN	female
Mirka	PROPN	female
Mirkka	PROPN	female
Mirko	PROPN	male
Miro	PROPN	male
Mirva	PROPN	female
Miska	PROPN	male
Miss	ADV	title
Missu	PROPN	female
Mitja	PROPN	male
Mitro	PROPN	male
Mkat	NOUN	measure
Mlle	ADV	title
Mlm	NOUN	measure
Mlx	NOUN	measure
Mm	NOUN	measure
Mme	ADV	title
Mmk	NOUN	currency
Mmol	NOUN	measure
Moa	PROPN	female
Mohammed	PROPN	male
Moldova	PROPN	country
Molly	PROPN	female
Mona	PROPN	female
Monaco	PROPN	country
Mongolia	PROPN	country
Monica	PROPN	female
Monika	PROPN	female
Monna	PROPN	female
Montenegro	PROPN	country
Montserrat	PROPN	country
Moona	PROPN	female
Morgan	PROPN	male
Moritz	PROPN	male
Mosambik	PROPN	country
Mpx	NOUN	measure
Mr	ADV	title
Mr.	NOUN	title
Mrad	NOUN	measure
Mrs	ADV	title
Ms	NOUN	measure|title
Msr	NOUN	measure
Mt	NOUN	measure
MuK	NOUN	title
MuL	NOUN	title
MuM	NOUN	title
MuT	NOUN	title
Muru	PROPN	female
My	PROPN	female
Myanmar	PROPN	country
M°C	NOUN	measure
Märit	PROPN	female
Märta	PROPN	female
Måns	PROPN	male
Mårten	PROPN	male
MΩ	NOUN	measure
M€	NOUN	currency
N$	NOUN	currency
N	NOUN	currency|measure|title
NAD	NOUN	currency
NGN	NOUN	currency
NIC	NOUN	currency
NIO	NOUN	currency
NKP	PROPN	polit
NKr	NOUN	currency
NLG	NOUN	currency
NOK	NOUN	currency
NPR	NOUN	currency
NT$	NOUN	currency
NV	NOUN	org
NZ$	NOUN	currency
NZD	NOUN	currency
Nadia	PROPN	female
Nadja-Mari	PROPN	female
Namibia	PROPN	country
Nana	PROPN	female
Nancy	PROPN	female
Nanna	PROPN	female
Nanne	PROPN	female
Nanni	PROPN	female
Nanny	PROPN	female
Naomi	PROPN	female
Natalia	PROPN	female
Natalie	PROPN	female
Natanael	PROPN	male
Nathan	PROPN	male
Nauru	PROPN	country
Navidad	PROPN	female
Nea	PROPN	female
Nea-Natalia	PROPN	female
Neea	PROPN	female
Neela	PROPN	female
Neil	PROPN	male
Neitsytsaaret	PROPN	country
Nella	PROPN	female
Nelli	PROPN	female
Nelonen	PROPN	media
Nemo	PROPN	male
Neo	PROPN	male
Nepal	PROPN	country
Nestor	PROPN	male
Nestori	PROPN	male
Netta	PROPN	female
Nia	PROPN	female
Nicaragua	PROPN	country
Nicholas	PROPN	male
Nick	PROPN	male
Nicky	PROPN	male
Niclas	PROPN	male
Nico	PROPN	male
Nicola	PROPN	female
Nicolas	PROPN	male
Nicole	PROPN	female
Niger	PROPN	country
Nigeria	PROPN	country
Niilo	PROPN	male
Niina	PROPN	female
Niki	PROPN	male
Nikita	PROPN	female
Nikke	PROPN	male
Niklas	PROPN	male
Niko	PROPN	male
Niko-Petteri	PROPN	male
Nikodemus	PROPN	male
Nikola	PROPN	male|female
Nikolai	PROPN	male
Nikolas	PROPN	male
Nikolaus	PROPN	male
Nils	PROPN	male
Nils-Johan	PROPN	male
Nina	PROPN	female
Nina-Maria	PROPN	female
Ninetta	PROPN	female
Ninna	PROPN	female
Ninni	PROPN	female
Nipa	PROPN	male
Nita	PROPN	female
Niue	PROPN	country
Nkr	NOUN	currency
Nm	NOUN	measure
Noah	PROPN	male
Noel	PROPN	male
Noeli	PROPN	male
Nooa	PROPN	male
Noona	PROPN	female
Noora	PROPN	female
Nora	PROPN	female
Norfolkinsaari	PROPN	country
Norja	PROPN	country
Norsunluurannikko	PROPN	country
Nrs	NOUN	currency
Nu	NOUN	currency
Nuppu	PROPN	female
Nuutti	PROPN	male
Nykypäivä	PROPN	media
Nyyrikki	PROPN	male
OKM	NOUN	org
OM	NOUN	org
OMR	NOUN	currency
OPEC	PROPN	org
OPM	NOUN	org
OPO	NOUN	title
OTK	NOUN	title
OTL	NOUN	title
OTT	NOUN	title
Odin	PROPN	male
Ohto	PROPN	male
Oili	PROPN	female
Oiva	PROPN	male
Oivi	PROPN	female
Okko	PROPN	male
Ola	PROPN	male
Olav	PROPN	male
Olavi	PROPN	male
Ole	PROPN	male
Olga	PROPN	female
Oliver	PROPN	male
Olivia	PROPN	female
Olivier	PROPN	male
Olle	PROPN	male
Olli	PROPN	male
Olof	PROPN	male
Oman	PROPN	country
Onerva	PROPN	female
Onika	PROPN	female
Onni	PROPN	male
Oona	PROPN	female
Oona-Helena	PROPN	female
Ora	PROPN	male
Orlando	PROPN	male
Orvar	PROPN	male
Orvo	PROPN	male
Orvokki	PROPN	female
Oscar	PROPN	male
Oskar	PROPN	male
Oskari	PROPN	male
Osmo	PROPN	male
Ossi	PROPN	male
Ossian	PROPN	male
Osvald	PROPN	male
Otso	PROPN	male
Otteljaana	PROPN	female
Otto	PROPN	male
Outa-Maria	PROPN	female
Outi	PROPN	female
Ove	PROPN	male
OÜ	NOUN	org
P	NOUN	currency|measure
PA	NOUN	measure
PAB	NOUN	currency
PBq	NOUN	measure
PC	NOUN	measure
PEI	NOUN	currency
PEN	NOUN	currency
PES	NOUN	currency
PF	NOUN	measure
PGK	NOUN	currency
PH	NOUN	measure
PHP	NOUN	currency
PHz	NOUN	measure
PJ	NOUN	measure
PK	NOUN	measure
PKR	NOUN	currency
PLM	NOUN	org
PLN	NOUN	currency
PLZ	NOUN	currency
PN	NOUN	measure
PPa	NOUN	measure
PS	PROPN	polit
PT	NOUN	measure
PT	PROPN	measure
PTE	NOUN	currency
PTO	NOUN	title
PV	NOUN	measure
PW	NOUN	measure
PWb	NOUN	measure
PYG	NOUN	currency
Pa	NOUN	measure
Paavali	PROPN	male
Paavo	PROPN	male
Paavo-Ilari	PROPN	male
Pablo	PROPN	male
Paikallisuutiset	PROPN	media
Pakistan	PROPN	country
Palau	PROPN	country
Palestiina	PROPN	country
Palestiinalaisalue	PROPN	country
Palmer	PROPN	male
Pamela	PROPN	female
Panama	PROPN	country
Panu	PROPN	male
Paolo	PROPN	male
Papua-Uusi-Guinea	PROPN	country
Paraguay	PROPN	country
Pasi	PROPN	male
Patricia	PROPN	female
Patrick	PROPN	male
Patrik	PROPN	male
Paul	PROPN	male
Paula	PROPN	female
Pauli	PROPN	male
Pauliina	PROPN	female
Paulina	PROPN	female
Paulus	PROPN	male
Pcd	NOUN	measure
Pedro	PROPN	male
Peetu	PROPN	male
Peik	PROPN	male
Pekka	PROPN	male
Pekko	PROPN	male
Pellervo	PROPN	male
Pentti	PROPN	male
Peppi	PROPN	female
Peppiina	PROPN	female
Peppina	PROPN	female
Per	PROPN	male
Perhonjokilaakso	PROPN	media
Pernilla	PROPN	female
Pertti	PROPN	male
Perttu	PROPN	male
Peru	PROPN	country
Pessi	PROPN	male
Peter	PROPN	male
Petja	PROPN	male
Petra	PROPN	female
Petri	PROPN	male
Petrik	PROPN	male
Petro	PROPN	male
Petrus	PROPN	male
Petter	PROPN	male
Petteri	PROPN	male
Petti	PROPN	male
Petäjävesi	PROPN	media
Pg	NOUN	measure
Ph.D.	NOUN	title
Phil	PROPN	male
Philip	PROPN	male
Phoenix	PROPN	male
Pia	PROPN	female
Pielavesi-Keitele	PROPN	media
Pielisjokiseutu	PROPN	media
Pierre	PROPN	male
Pietari	PROPN	male
Pieter	PROPN	male
Pihla	PROPN	female
Piia	PROPN	female
Piia-Maria	PROPN	female
Pilvi	PROPN	female
Pinja	PROPN	female
Pinjaliina	PROPN	female
Pirita	PROPN	female
Piritta	PROPN	female
Pirjo	PROPN	female
Pirkka	PROPN	male
Pirkko	PROPN	female
Pirkko-Liisa	PROPN	female
Pitcairn	PROPN	country
Pitäjäläinen	PROPN	media
Pitäjänuutiset	PROPN	media
PkO	NOUN	title
Pkat	NOUN	measure
Plm	NOUN	measure
Plx	NOUN	measure
Pm	NOUN	measure
Pmol	NOUN	measure
Pohjalainen	PROPN	media
Pohjois-Irlanti	PROPN	country
Pohjois-Korea	PROPN	country
Pohjois-Mariaanit	PROPN	country
Pohjois-Satakunta	PROPN	media
Pontus	PROPN	male
Portugali	PROPN	country
Postimees	PROPN	media
Pra	NOUN	currency
Prad	NOUN	measure
Pravda	PROPN	media
Priitta	PROPN	female
Príncipe	PROPN	country
Ps	NOUN	measure
PsK	NOUN	title
PsL	NOUN	title
PsM	NOUN	title
PsT	NOUN	title
Psr	NOUN	measure
Pulmu	PROPN	female
Puola	PROPN	country
Puruvesi	PROPN	media
Pyhäjokiseutu	PROPN	media
Pyry	PROPN	male
P°C	NOUN	measure
Päivi	PROPN	female
Päivikki	PROPN	female
Päiviö	PROPN	male
Päivä	PROPN	female
Päivö	PROPN	male
Pälvi	PROPN	female
PΩ	NOUN	measure
Q	NOUN	currency
QAR	NOUN	currency
QR	NOUN	currency
Qatar	PROPN	country
R$	NOUN	currency
R	NOUN	currency
RD$	NOUN	currency
RHD	NOUN	currency
RI	PROPN	currency
RKP	PROPN	polit
RM	NOUN	currency
RO	PROPN	currency
ROL	NOUN	currency
RON	NOUN	currency
RSD	NOUN	currency
RUB	NOUN	currency
RUR	NOUN	currency
RVLE	NOUN	org
RWF	NOUN	currency
Raafael	PROPN	male
Raakel	PROPN	female
Rabbe	PROPN	male
Rafael	PROPN	male
Ragna	PROPN	female
Ragnar	PROPN	male
Ragnborg	PROPN	female
Ragnhild	PROPN	female
Ragni	PROPN	female
Ragnvald	PROPN	male
Raija	PROPN	female
Raila	PROPN	female
Raili	PROPN	female
Raimo	PROPN	male
Raine	PROPN	male
Rainer	PROPN	male
Raino	PROPN	male
Raisa	PROPN	female
Raita	PROPN	female
Rakel	PROPN	female
Ralf	PROPN	male
Ralph	PROPN	male
Rami	PROPN	male
Ramona	PROPN	female
Rannikkoseutu	PROPN	media
Ranska	PROPN	country
Rantalakeus	PROPN	media
Rantapohja	PROPN	media
Rasmus	PROPN	male
Rauha	PROPN	female
Raul	PROPN	male
Rauli	PROPN	male
Rauna	PROPN	female
Rauni	PROPN	female
Rauno	PROPN	male
Raymond	PROPN	male
Rbl	NOUN	currency
Re.	NOUN	currency
Rea	PROPN	female
Rebecca	PROPN	female
Rebekka	PROPN	female
Reea-Maaret	PROPN	female
Reeta	PROPN	female
Reetta	PROPN	female
Regina	PROPN	female
Regine	PROPN	female
Reija	PROPN	female
Reijo	PROPN	male
Reima	PROPN	male
Reinhold	PROPN	male
Reino	PROPN	male
Reko	PROPN	male
Rene	PROPN	male
Renée	PROPN	female
Resat	PROPN	male
Retu-Petteri	PROPN	male
Rianna	PROPN	female
Richard	PROPN	male
Rick	PROPN	male
Rigmor	PROPN	female
Riia	PROPN	female
Riikka	PROPN	female
Riikkaliisa	PROPN	female
Riiko	PROPN	male
Riina	PROPN	female
Riina-Kaisa	PROPN	female
Riitta	PROPN	female
Riitta-Liisa	PROPN	female
Rikard	PROPN	male
Rikhard	PROPN	male
Riku	PROPN	male
Ristiina	PROPN	female
Risto	PROPN	male
Rita	PROPN	female
Ritva	PROPN	female
Ritva-Liisa	PROPN	female
Rkr	NOUN	currency
Robert	PROPN	male
Roberto	PROPN	male
Robin	PROPN	male
Rocky	PROPN	male
Roger	PROPN	male
Roland	PROPN	male
Rolf	PROPN	male
Romania	PROPN	country
Ronald	PROPN	male
Roni	PROPN	male
Roni-Antero	PROPN	male
Ronja	PROPN	female
Ronny	PROPN	male
Roobert	PROPN	male
Roope	PROPN	male
Roosa	PROPN	female
Roosa-Maria	PROPN	female
Rosa	PROPN	female
Rosa-Maria	PROPN	female
Rosita	PROPN	female
Roy	PROPN	male
Rp	NOUN	currency
Rs.	NOUN	currency
Ruanda	PROPN	country
Ruben	PROPN	male
Ruby	PROPN	female
Rudolf	PROPN	male
Rufus	PROPN	male
Runa	PROPN	female
Runar	PROPN	male
Rune	PROPN	male
Runo	PROPN	male
Ruotsi	PROPN	country
Rurik	PROPN	male
Rut	PROPN	female
Ruusu	PROPN	female
Ruusu-Rosanna	PROPN	female
Ruut	PROPN	female
Ryan	PROPN	male
Réunion	PROPN	country
S$	NOUN	currency
S	NOUN	measure
SA	PROPN	org
SAR	NOUN	currency
SBD	NOUN	currency
SCR	NOUN	currency
SDD	NOUN	currency
SDG	NOUN	currency
SDP	PROPN	polit
SE	NOUN	org
SEK	NOUN	currency
SGD	NOUN	currency
SHO	NOUN	title
SHP	NOUN	currency
SI$	NOUN	currency
SIT	NOUN	currency
SK	NOUN	title
SKDL	PROPN	polit
SKK	NOUN	currency
SKL	PROPN	polit
SKP	PROPN	polit
SKr	NOUN	currency
SLL	NOUN	currency
SMP	NOUN	polit
SNT	NOUN	geo
SOS	NOUN	currency
SR	NOUN	currency
SRD	NOUN	currency
SRG	NOUN	currency
SRl	NOUN	currency
SSP	PROPN	currency
ST	NOUN	title
STD	NOUN	currency
STM	NOUN	org
STT	PROPN	media
SUPO	NOUN	org
SUR	NOUN	currency
SVC	NOUN	currency
SYP	PROPN	currency
SZL	NOUN	currency
Saaga	PROPN	female
Saana	PROPN	female
Saara	PROPN	female
Saara-Maria	PROPN	female
Sabina	PROPN	female
Sade	PROPN	female
Saga	PROPN	female
Saija	PROPN	female
Saila	PROPN	female
Saima	PROPN	female
Saimi	PROPN	female
Saini	PROPN	female
Saint-Barthélemy	PROPN	country
Saint-Martin	PROPN	country
Saint-Pierre	PROPN	country
Sakari	PROPN	male
Saksa	PROPN	country
Saku	PROPN	male
Salla	PROPN	female
Salla-Maarit	PROPN	female
Salla-Maija	PROPN	female
Salli	PROPN	female
Sally	PROPN	female
Salme	PROPN	female
Salomo	PROPN	male
Salomon	PROPN	male
Salomonsaaret	PROPN	country
Salvador	PROPN	male
Sam	PROPN	male
Sambia	PROPN	country
Sami	PROPN	male
Sami-Petteri	PROPN	male
Samoa	PROPN	country
Sampo	PROPN	media|male
Samppa	PROPN	male
Sampsa	PROPN	male
Samu	PROPN	male
Samuel	PROPN	male
Samuli	PROPN	male
Sandra	PROPN	female
Sandra-Rosa	PROPN	female
Sanelma	PROPN	female
Sani	PROPN	female
Sanna	PROPN	female
Sanna-Liina	PROPN	female
Sanna-Liisa	PROPN	female
Sanna-Mari	PROPN	female
Sanna-Maria	PROPN	female
Sanni	PROPN	female
Sanni-Kaisa	PROPN	female
Santeri	PROPN	male
Santtu	PROPN	male
Sara	PROPN	female
Sara-Sofia	PROPN	female
Sarah	PROPN	female
Sari	PROPN	female
Sari-Katja	PROPN	female
Sari-Margit	PROPN	female
Sarita	PROPN	female
Sarlotta	PROPN	female
Sarri	PROPN	female
Saska	PROPN	male
Sasu	PROPN	male
Sasu-Matti	PROPN	male
Satu	PROPN	female
Satu-Anne	PROPN	female
Satumarja	PROPN	female
Saudi-Arabia	PROPN	country
Saul	PROPN	male
Sauli	PROPN	male
Saunalahti	PROPN	media
Scott	PROPN	male
Sdp	PROPN	polit
Sean	PROPN	male
Sebastian	PROPN	male
Seena	PROPN	female
Seidi	PROPN	female
Seija	PROPN	female
Selena	PROPN	female
Selim	PROPN	male
Selina	PROPN	female
Selja	PROPN	female
Selma	PROPN	female
Senegal	PROPN	country
Senja	PROPN	female
Senni	PROPN	female
Senni-Liisa	PROPN	female
Seppo	PROPN	male
Serafia	PROPN	female
Serafiina	PROPN	female
Serbia	PROPN	country
Serena	PROPN	female
Severi	PROPN	male
Severin	PROPN	male
Seychellit	PROPN	country
Sf	NOUN	currency
Sfr	NOUN	currency
Shannon	PROPN	male
Sharon	PROPN	female
Sieviläinen	PROPN	media
Sigfrid	PROPN	female
Signe	PROPN	female
Signhild	PROPN	female
Sigrid	PROPN	female
Sigurd	PROPN	male
Sigvard	PROPN	male
Siikajokilaakso	PROPN	media
Siina	PROPN	female
Siiri	PROPN	female
Sikke	PROPN	female
Silja	PROPN	female
Silke	PROPN	female
Silva	PROPN	female
Silvia	PROPN	female
Silvo	PROPN	male
Simo	PROPN	male
Simon	PROPN	male
Simona	PROPN	female
Simone	PROPN	female
Simonpoika	PROPN	male
Sina	PROPN	female
Singapore	PROPN	country
Sini	PROPN	female
Sini-Maaria	PROPN	female
Sini-Tuulia	PROPN	female
Sinikka	PROPN	female
Sinna	PROPN	female
Sipi	PROPN	male
Sippo	PROPN	male
Sira	PROPN	female
Sirena	PROPN	female
Siri	PROPN	female
Sirja	PROPN	female
Sirje	PROPN	female
Sirke	PROPN	female
Sirkka	PROPN	female
Sirkku	PROPN	female
Sirpa	PROPN	female
Siru	PROPN	female
Sisko	PROPN	female
Sissi	PROPN	female
Sisu	PROPN	male
Siv	PROPN	female
Sivi	PROPN	female
Sixten	PROPN	male
Sk	NOUN	currency
Slovakia	PROPN	country
Slovenia	PROPN	country
Sofia	PROPN	female
Sofie	PROPN	female
Sofiina	PROPN	female
Sohvi	PROPN	female
Soila	PROPN	female
Soile	PROPN	female
Soili	PROPN	female
Soini	PROPN	male
Sointu	PROPN	female
Soja	PROPN	female
Solja	PROPN	female
Solveig	PROPN	female
Somalia	PROPN	country
Sonera	PROPN	media
Sonja	PROPN	female
Sophia	PROPN	female
Sorja	PROPN	female
Staffan	PROPN	male
Stefan	PROPN	male
Stella	PROPN	female
Sten	PROPN	male
Stephan	PROPN	male
Stephanie	PROPN	female
Stephen	PROPN	male
Steve	PROPN	male
Steven	PROPN	male
Stig	PROPN	male
Stina	PROPN	female
Stuart	PROPN	male
Sture	PROPN	male
Styrbjörn	PROPN	male
Sub	PROPN	media
Sudan	PROPN	country
Sulevi	PROPN	male
Sulho	PROPN	male
Sulo	PROPN	male
Sune	PROPN	male
Suoma	PROPN	female
Suomenmaa	PROPN	media
Suometar	PROPN	female
Suomi	PROPN	country
Suriname	PROPN	country
Susanna	PROPN	female
Susanne	PROPN	female
Suur-Keuruu	PROPN	media
Suvi	PROPN	female
Suvi-Maria	PROPN	female
Suvi-Tuulikki	PROPN	female
Sv	NOUN	measure
Svalbard	PROPN	country
Svante	PROPN	male
Svea	PROPN	female
Sveitsi	PROPN	country
Sven	PROPN	male
Sverker	PROPN	male
SwF	NOUN	currency
Swazimaa	PROPN	country
Syd-Österbotten	PROPN	media
Sydän-Satakunta	PROPN	media
Sylvester	PROPN	male
Sylvi	PROPN	female
Sylvia	PROPN	female
Synnöve	PROPN	female
Syyria	PROPN	country
Säde	PROPN	female
Sören	PROPN	male
T$	NOUN	currency
T	NOUN	currency
TA	NOUN	measure
TALK	NOUN	org
TAPRI	PROPN	org
TBq	NOUN	measure
TC	NOUN	measure
TE	NOUN	org
TF	PROPN	measure
TH	NOUN	measure
THB	NOUN	currency
THz	NOUN	measure
TJ	NOUN	measure
TJR	NOUN	currency
TJS	NOUN	currency
TK	NOUN	measure
TKT	NOUN	org
TL	NOUN	title|currency
TM	PROPN	org
TMM	NOUN	currency
TMT	NOUN	currency
TN	NOUN	measure|org
TND	NOUN	currency
TOP	NOUN	currency
TPE	NOUN	currency
TPK	PROPN	org
TPa	NOUN	measure
TRL	NOUN	currency
TRY	NOUN	currency
TT$	NOUN	currency
TT	NOUN	title
TTD	NOUN	currency
TTK	NOUN	title
TTL	NOUN	title
TTM	NOUN	title
TTT	NOUN	title
TV	NOUN	measure
TV1	PROPN	media
TV2	PROPN	media
TW	NOUN	measure
TWD	NOUN	currency
TWb	NOUN	measure
TZS	NOUN	currency
TaK	NOUN	title
TaL	NOUN	title
TaM	NOUN	title
TaT	NOUN	title
Taani	PROPN	male
Taavetti	PROPN	male
Taavi	PROPN	male
Tadžikistan	PROPN	country
Tage	PROPN	male
Tahvana	PROPN	male
Tahvo	PROPN	male
Taija	PROPN	female
Taija-Annika	PROPN	female
Taika	PROPN	female
Taikatuuli	PROPN	female
Taimi	PROPN	female
Taina	PROPN	female
Taisa	PROPN	female
Taisto	PROPN	male
Taito	PROPN	male
Taiwan	PROPN	country
Taloussanomat	PROPN	media
Talvikki	PROPN	female
Tamar	PROPN	male
Tamara	PROPN	female
Taneli	PROPN	male
Tanja	PROPN	female
Tanja-Kaarina	PROPN	female
Tansania	PROPN	country
Tanska	PROPN	country
Tanya	PROPN	female
Tapani	PROPN	male
Tapio	PROPN	male
Tara	PROPN	female
Tarika	PROPN	female
Tarja	PROPN	female
Tarmo	PROPN	male
Taru	PROPN	female
Tarvo	PROPN	male
Tatjana	PROPN	female
Tatu	PROPN	male
Tauno	PROPN	male
Tcd	NOUN	measure
TeK	NOUN	title
TeL	NOUN	title
TeM	NOUN	title
TeT	NOUN	title
Tea	PROPN	female
Ted	PROPN	male
Teea	PROPN	female
Teema	PROPN	media
Teemu	PROPN	male
Teeo	PROPN	male
Teija	PROPN	female
Teijo	PROPN	male
Teisko-Aitolahti	PROPN	media
Tejuka	PROPN	media
Tekla	PROPN	female
Telia-Sonera	PROPN	media
TeliaSonera	PROPN	media
Tellervo	PROPN	female
Tenho	PROPN	male
Teodor	PROPN	male
Teppo	PROPN	male
Teresa	PROPN	female
Terese	PROPN	female
Teresia	PROPN	female
Terhi	PROPN	female
Terhi-Elina	PROPN	female
Terhikki	PROPN	female
Terho	PROPN	male
Tero	PROPN	male
Terry	PROPN	male
Terttu	PROPN	female
Tervareitti	PROPN	media
Tessa	PROPN	female
Teuvo	PROPN	male
Tg	NOUN	measure
Thaimaa	PROPN	country
Theo	PROPN	male
Theodor	PROPN	male
Theresa	PROPN	female
Therese	PROPN	female
Thomas	PROPN	male
Tia	PROPN	female
Tianna	PROPN	female
Tihvo	PROPN	male
Tiia	PROPN	female
Tiia-Maria	PROPN	female
Tiiatuulia	PROPN	female
Tiina	PROPN	female
Tiina-Kaisa	PROPN	female
Tiitu	PROPN	female
Tiitus	PROPN	male
Tiiu	PROPN	female
Tilda	PROPN	female
Tilde	PROPN	female
Tilhi	PROPN	female
Tim	PROPN	male
Timi	PROPN	male
Timo	PROPN	male
Tina	PROPN	female
Tindra	PROPN	female
Tinja	PROPN	female
Tinka	PROPN	female
Tino	PROPN	male
Titta	PROPN	female
Tk	NOUN	currency
TkK	NOUN	title
TkL	NOUN	title
TkT	NOUN	title
Tkat	NOUN	measure
Tkr	NOUN	currency
Tlm	NOUN	measure
Tlx	NOUN	measure
Tm	NOUN	measure
Tmol	NOUN	measure
Tobago	PROPN	country
Tobias	PROPN	male
Togo	PROPN	country
Toimi	PROPN	male
Toini	PROPN	female
Toivo	PROPN	male
Tokelau	PROPN	country
Tom	PROPN	male
Tomas	PROPN	male
Tomi	PROPN	male
Tommi	PROPN	male
Tommy	PROPN	male
Tomppa	PROPN	male
Tonga	PROPN	country
Toni	PROPN	male
Tony	PROPN	male
Topi	PROPN	male
Topias	PROPN	male
Tor	PROPN	male
Tora	PROPN	female
Torbjörn	PROPN	male
Torborg	PROPN	female
Tord	PROPN	male
Tore	PROPN	male
Torgny	PROPN	male
Torhild	PROPN	female
Torkel	PROPN	male
Torolf	PROPN	male
Torsten	PROPN	male
Torsti	PROPN	male
Torvald	PROPN	male
Touko	PROPN	male
Tove	PROPN	female
Tracey	PROPN	female
Trine	PROPN	female
Trinidad	PROPN	country
Trude	PROPN	female
Tryggve	PROPN	male
Ts	NOUN	measure
Tsr	NOUN	measure
TtK	NOUN	title
TtL	NOUN	title
TtM	NOUN	title
TtT	NOUN	title
Tua	PROPN	female
Tug	NOUN	currency
Tuija	PROPN	female
Tuikku	PROPN	female
Tuire	PROPN	female
Tuisku	PROPN	male
Tunisia	PROPN	country
Tuomas	PROPN	male
Tuomi	PROPN	female
Tuomo	PROPN	male
Tuovi	PROPN	female
Ture	PROPN	male
Turkka	PROPN	male
Turkki	PROPN	country
Turkmenistan	PROPN	country
Turo	PROPN	male
Tuukka	PROPN	male
Tuula	PROPN	female
Tuuli	PROPN	female
Tuulia	PROPN	female
Tuulikki	PROPN	female
Tuure	PROPN	male
Tuutikki	PROPN	female
Tuvalu	PROPN	country
Tyra	PROPN	female
Tytti	PROPN	female
Tyyne	PROPN	female
Tyyni	PROPN	female
T°C	NOUN	measure
Tšad	PROPN	country
Tšekki	PROPN	country
TΩ	NOUN	measure
UAH	NOUN	currency
UAK	NOUN	currency
UGS	NOUN	currency
UGX	NOUN	currency
UM	NOUN	currency|org
UNCED	NOUN	event
UNCTAD	NOUN	event
UNHCR	PROPN	title
US$	NOUN	currency
USD	NOUN	currency
USN	NOUN	currency
USS	NOUN	currency
UYI	NOUN	currency
UYP	NOUN	currency
UYU	NOUN	currency
UZS	NOUN	currency
Uganda	PROPN	country
Ukko	PROPN	male
Ukraina	PROPN	country
Ulf	PROPN	male
Uljas	PROPN	male
Ulla	PROPN	female
Ulpu	PROPN	female
Ulriikka	PROPN	female
Ulrik	PROPN	male
Ulrika	PROPN	female
Unelma	PROPN	female
Unkari	PROPN	country
Uno	PROPN	male
Untamo	PROPN	male
Unto	PROPN	male
Uolevi	PROPN	male
Uoti	PROPN	male
Ur$	NOUN	currency
Urban	PROPN	male
Urda	PROPN	female
Urho	PROPN	male
Urmas	PROPN	male
Urpo	PROPN	male
Ursula	PROPN	female
Uruguay	PROPN	country
Usko	PROPN	male
Uuno	PROPN	male
Uusi-Kaledonia	PROPN	country
Uusi-Seelanti	PROPN	country
Uusimaa	PROPN	media
Uutis-Jousi	PROPN	media
Uzbekistan	PROPN	country
V	NOUN	measure
VA	NOUN	measure
VAHO	PROPN	org
VEB	NOUN	currency
VEF	NOUN	currency
VHL	NOUN	org
VKS	NOUN	title
VM	NOUN	org
VN	NOUN	title
VN	PROPN	org
VND	NOUN	currency
VNK	NOUN	org
VNN	NOUN	currency
VO	NOUN	title
VT	NOUN	currency|title
VTK	NOUN	title
VTL	NOUN	title
VTM	NOUN	title
VTT	NOUN	title
VUV	NOUN	currency
VYO	NOUN	org
Vaiht.	NOUN	polit|org
Valborg	PROPN	female
Valdemar	PROPN	male
Valentin	PROPN	male
Valentina	PROPN	female
Valfrid	PROPN	male
Valio	PROPN	male
Valko-Venäjä	PROPN	country
Valma	PROPN	female
Valmis	PROPN	male
Valo	PROPN	male
Valpuri	PROPN	female
Valter	PROPN	male
Valto	PROPN	male
Valtteri	PROPN	male
Vanamo	PROPN	female
Vanessa	PROPN	female
Vanuatu	PROPN	country
Vappu	PROPN	female
Varma	PROPN	female
Varpu	PROPN	female
Vas.	NOUN	polit|org
Vasabladet	PROPN	media
Vatikaani	PROPN	country
Vaula	PROPN	female
Veea	PROPN	female
Veera	PROPN	female
Veera-Maria	PROPN	female
Veeti	PROPN	male
Veijo	PROPN	male
Veikka	PROPN	male
Veikko	PROPN	male
Veini	PROPN	male
Veli	PROPN	male
Veli-Pekka	PROPN	male
Vellamo	PROPN	female
Vendla	PROPN	female
Venezuela	PROPN	country
Venla	PROPN	female
Ventura	PROPN	male
Venäjä	PROPN	country
Vera	PROPN	female
Verna	PROPN	female
Verner	PROPN	male
Verneri	PROPN	male
Veronika	PROPN	female
Vertti	PROPN	male
Vesa	PROPN	male
Vesanpoika	PROPN	male
Vesta	PROPN	female
Victor	PROPN	male|female
Victoria	PROPN	female
Vidar	PROPN	male
Viena	PROPN	female
Vieno	PROPN	female
Vietnam	PROPN	country
Viggo	PROPN	male
Vihr.	NOUN	polit|org
Vihtori	PROPN	male
Viikko-Häme	PROPN	media
Viiskunta	PROPN	media
Viispiikkinen	PROPN	media
Viivi	PROPN	female
Viivi-Lotta	PROPN	female
Viking	PROPN	male
Viktor	PROPN	male
Viktoria	PROPN	female
Vilhelm	PROPN	male
Vilhelmiina	PROPN	female
Vilhelmina	PROPN	female
Vilho	PROPN	male
Vili	PROPN	male
Vilja	PROPN	female
Viljam	PROPN	male
Viljami	PROPN	male
Viljo	PROPN	male
Ville	PROPN	male
Vilma	PROPN	female
Vilppu	PROPN	male
Vincent	PROPN	male
Vinski	PROPN	male
Viola	PROPN	female
Vipunen	PROPN	male
Virginia	PROPN	female
Viro	PROPN	country
Virpi	PROPN	female
Virva	PROPN	female
Virve	PROPN	female
Visa	PROPN	male
Vivan	PROPN	female
Viveka	PROPN	female
Vivi	PROPN	female
Vivian	PROPN	female
Viviana	PROPN	female
Vladimir	PROPN	male
Voitto	PROPN	male
Volmar	PROPN	male
Volter	PROPN	male
Vuokko	PROPN	female
Väinämö	PROPN	male
Väinämöinen	PROPN	male
Väinö	PROPN	male
W	NOUN	measure
WST	NOUN	currency
Wagner	PROPN	male
Waldemar	PROPN	male
Walter	PROPN	male
Waltteri	PROPN	male
Wb	NOUN	measure
Werner	PROPN	male
Werneri	PROPN	male
Wh	NOUN	measure
Wilbur	PROPN	male
Wilhelm	PROPN	male
Wilhelmiina	PROPN	female
Wilhelmina	PROPN	female
Wiljam	PROPN	male
Wiljami	PROPN	male
William	PROPN	male
Willy	PROPN	male
Wilma	PROPN	female
Wilmer	PROPN	male
Winston	PROPN	male
Wolfgang	PROPN	male
Ws	NOUN	measure
XAF	NOUN	currency
XAG	NOUN	currency
XAU	NOUN	currency
XBA	NOUN	currency
XBB	NOUN	currency
XBC	NOUN	currency
XBD	NOUN	currency
XCD	NOUN	currency
XDR	NOUN	currency
XEU	NOUN	currency
XFO	NOUN	currency
XFU	NOUN	currency
XOF	NOUN	currency
XPD	NOUN	currency
XPF	NOUN	currency
XPT	NOUN	currency
XRE	NOUN	currency
XTS	NOUN	currency
XXX	NOUN	currency
Y	NOUN	currency
Y2K	NOUN	time
YA	NOUN	measure
YBq	NOUN	measure
YC	NOUN	measure
YDD	NOUN	currency
YER	NOUN	currency
YF	NOUN	measure
YH	NOUN	measure
YHz	NOUN	measure
YJ	NOUN	measure
YLE	PROPN	media
YM	NOUN	org
YN	NOUN	measure
YPa	NOUN	measure
YRl	NOUN	currency
YS	NOUN	measure
YT	PROPN	measure
YTK	NOUN	title
YTL	NOUN	title|org
YTM	NOUN	title
YTT	NOUN	title
YUD	NOUN	currency
YUM	NOUN	currency
YUN	NOUN	currency
YUR	NOUN	currency
YV	NOUN	measure
YW	NOUN	measure
YWb	NOUN	measure
Yanna	PROPN	female
Yasmina	PROPN	female
Ycd	NOUN	measure
Yg	NOUN	measure
Yhdysvallat	PROPN	country
Ykat	NOUN	measure
Ykkössanomat	PROPN	media
Ylermi	PROPN	male
Ylm	NOUN	measure
Ylva	PROPN	female
Ylx	NOUN	measure
Ylä-Kainuu	PROPN	media
Ylä-Karjala	PROPN	media
Ylä-Satakunta	PROPN	media
Ym	NOUN	measure
Ymol	NOUN	measure
Yngvar	PROPN	male
Yngve	PROPN	male
Yrad	NOUN	measure
Yrjänä	PROPN	male
Yrjö	PROPN	male
Yrsa	PROPN	female
Ys	NOUN	measure
Ysr	NOUN	measure
Yvonne	PROPN	female
Y°C	NOUN	measure
YΩ	NOUN	measure
Z$	NOUN	currency
ZA	NOUN	measure
ZAL	NOUN	currency
ZAR	NOUN	currency
ZBq	NOUN	measure
ZC	NOUN	measure
ZF	NOUN	measure
ZH	NOUN	measure
ZHz	NOUN	measure
ZJ	NOUN	measure
ZK	NOUN	measure
ZMK	NOUN	currency
ZMW	NOUN	currency
ZN	NOUN	measure
ZPa	NOUN	measure
ZRN	NOUN	currency
ZRZ	NOUN	currency
ZS	NOUN	measure
ZT	NOUN	measure
ZV	NOUN	measure
ZW	NOUN	measure
ZWD	NOUN	currency
ZWL	NOUN	currency
ZWR	NOUN	currency
ZWb	NOUN	measure
Zacharias	PROPN	male
Zaire	PROPN	country
Zambia	PROPN	country
Zcd	NOUN	measure
Zg	NOUN	measure
Zimbabwe	PROPN	country
Zkat	NOUN	measure
Zl	NOUN	currency
Zlm	NOUN	measure
Zlx	NOUN	measure
Zm	NOUN	measure
Zmol	NOUN	measure
Zrad	NOUN	measure
Zs	NOUN	measure
Zsr	NOUN	measure
Z°C	NOUN	measure
ZΩ	NOUN	measure
a	NOUN	time
a.D.	NOUN	time
a.m.	NOUN	time
aA	NOUN	measure
aBq	NOUN	measure
aC	NOUN	measure
aF	NOUN	measure
aH	NOUN	measure
aHz	NOUN	measure
aJ	NOUN	measure
aK	NOUN	measure
aN	NOUN	measure
aPa	NOUN	measure
aS	NOUN	measure
aT	NOUN	measure
aV	NOUN	measure
aW	NOUN	measure
aWb	NOUN	measure
ab	NOUN	org
abhaasi	NOUN	language
abp	NOUN	org
acd	NOUN	measure
ad	NOUN	title
adangme	NOUN	language
adyge	NOUN	language
afar	NOUN	language
afganistanilainen	ADJ	country
afganistanilainen	NOUN	inhabitant
afrihili	NOUN	language
afrikaans	NOUN	language
ag	NOUN	measure|org
aghem	NOUN	language
agrol.	NOUN	title
agrologi	NOUN	title
agron.	NOUN	title
agronomi	NOUN	title
ahlaislainen	ADJ	country
ahlaislainen	NOUN	inhabitant
aimara	NOUN	language
ainu	NOUN	language
aitolahtelainen	ADJ	country
aitolahtelainen	NOUN	inhabitant
akaalainen	ADJ	country
akaalainen	NOUN	inhabitant
akan	NOUN	language
akat	NOUN	measure
akkadi	NOUN	language
alahärmäläinen	ADJ	country
alahärmäläinen	NOUN	inhabitant
alankomaalainen	ADJ	country
alankomaalainen	NOUN	inhabitant
alasaksa	NOUN	language
alasorbi	NOUN	language
alastarolainen	ADJ	country
alastarolainen	NOUN	inhabitant
alatorniolainen	ADJ	country
alatorniolainen	NOUN	inhabitant
alaveteliläinen	ADJ	country
alaveteliläinen	NOUN	inhabitant
alavieskalainen	ADJ	country
alavieskalainen	NOUN	inhabitant
alavutelainen	ADJ	country
alavutelainen	NOUN	inhabitant
albania	NOUN	language
albanialainen	ADJ	country
albanialainen	NOUN	inhabitant
aleutti	NOUN	language
algerialainen	ADJ	country
algerialainen	NOUN	inhabitant
algonkikieli	NOUN	language
alik.	NOUN	title
alikersantti	NOUN	title
alil.	NOUN	title
aliluutnantti	NOUN	title
aliupseeri	NOUN	title
alm	NOUN	measure
altai	NOUN	language
aluepäällikkö	NOUN	title
alx	NOUN	measure
am	NOUN	measure
amerikanenglanti	NOUN	language
amerikanespanja	NOUN	language
amerikansamoalainen	ADJ	country
amerikansamoalainen	NOUN	inhabitant
amerikkalainen	ADJ	country
amerikkalainen	NOUN	inhabitant
amhara	NOUN	language
amir.	NOUN	title
amiraali	NOUN	title
amk	NOUN	org
amol	NOUN	measure
andorralainen	ADJ	country
andorralainen	NOUN	inhabitant
angelniemeläinen	ADJ	country
angelniemeläinen	NOUN	inhabitant
angika	NOUN	language
angolalainen	ADJ	country
angolalainen	NOUN	inhabitant
anguillalainen	ADJ	country
anguillalainen	NOUN	inhabitant
anjalainen	ADJ	country
anjalainen	NOUN	inhabitant
anjalalainen	ADJ	country
anjalalainen	NOUN	inhabitant
antarktislainen	ADJ	country
antarktislainen	NOUN	inhabitant
antiguabarbudalainen	ADJ	country
antiguabarbudalainen	NOUN	inhabitant
anttolainen	ADJ	country
anttolainen	NOUN	inhabitant
anttolalainen	ADJ	country
anttolalainen	NOUN	inhabitant
ap.	NOUN	time
apassi	NOUN	language
apaššikieli	NOUN	language
apteekkineuvos	NOUN	title
apul.	NOUN	title
apul.prof.	NOUN	title
apulainen	NOUN	title
apulaisoikeusasiamies	NOUN	title
apulaisprofessori	NOUN	title
arabia	NOUN	language
arabiemiirikuntalainen	ADJ	country
arabiemiirikuntalainen	NOUN	inhabitant
arad	NOUN	measure
aragonia	NOUN	language
aramea	NOUN	language
arapaho	NOUN	language
arawak	NOUN	language
argentiinalainen	ADJ	country
argentiinalainen	NOUN	inhabitant
ark	NOUN	measure
ark.	NOUN	time
arkkiatri	NOUN	title
arkkit.	NOUN	title
arkkitehti	NOUN	title
armenia	NOUN	language
armenialainen	ADJ	country
armenialainen	NOUN	inhabitant
aromania	NOUN	language
artisti	NOUN	title
artjärveläinen	ADJ	country
artjärveläinen	NOUN	inhabitant
artjärvinen	ADJ	country
artjärvinen	NOUN	inhabitant
arubalainen	ADJ	country
arubalainen	NOUN	inhabitant
arv.	NOUN	title
arvoisa	ADJ	title
as	NOUN	measure
as.oy	NOUN	org
as.oy.	NOUN	org
asentaja	NOUN	title
asessori	NOUN	title
asiamies	NOUN	title
asianajaja	NOUN	title
asikkalainen	ADJ	country
asikkalainen	NOUN	inhabitant
asikkalalainen	ADJ	country
asikkalalainen	NOUN	inhabitant
askaislainen	ADJ	country
askaislainen	NOUN	inhabitant
askaistelainen	ADJ	country
askaistelainen	NOUN	inhabitant
askolalainen	ADJ	country
askolalainen	NOUN	inhabitant
asr	NOUN	measure
ass.	NOUN	title
assami	NOUN	language
assist.	NOUN	title
assistentti	NOUN	title
asturia	NOUN	language
asu	NOUN	language
ateso	NOUN	language
athabascakieli	NOUN	language
atm	NOUN	measure
atsam	NOUN	language
atšeh	NOUN	language
atšoli	NOUN	language
au.	NOUN	title
auralainen	ADJ	country
auralainen	NOUN	inhabitant
ausk.	NOUN	title
auskultantti	NOUN	title
australialainen	ADJ	country
australialainen	NOUN	inhabitant
australianenglanti	NOUN	language
autonasentaja	NOUN	title
autonkuljettaja	NOUN	title
avaari	NOUN	language
avesta	NOUN	language
avi	NOUN	org
awadhi	NOUN	language
ay	NOUN	org
ay.	NOUN	org
azerbaidžanilainen	ADJ	country
azerbaidžanilainen	NOUN	inhabitant
azeri	NOUN	language
a°C	NOUN	measure
aΩ	NOUN	measure
bafia	NOUN	language
bahamalainen	ADJ	country
bahamalainen	NOUN	inhabitant
bahrainilainen	ADJ	country
bahrainilainen	NOUN	inhabitant
balettineuvos	NOUN	title
bali	NOUN	language
bambara	NOUN	language
bamilekekieli	NOUN	language
bamum	NOUN	language
banda	NOUN	language
bangladeshilainen	ADJ	country
bangladeshilainen	NOUN	inhabitant
bantukieli	NOUN	language
bar	NOUN	measure
barbadoslainen	ADJ	country
barbadoslainen	NOUN	inhabitant
basaa	NOUN	language
baski	NOUN	language
batakkieli	NOUN	language
baškiiri	NOUN	language
bedža	NOUN	language
belgialainen	ADJ	country
belgialainen	NOUN	inhabitant
belizeläinen	ADJ	country
belizeläinen	NOUN	inhabitant
belutši	NOUN	language
bemba	NOUN	language
bena	NOUN	language
bengali	NOUN	language
beniniläinen	ADJ	country
beniniläinen	NOUN	inhabitant
berberikieli	NOUN	language
bermudalainen	ADJ	country
bermudalainen	NOUN	inhabitant
bhodžpuri	NOUN	language
bhutanilainen	ADJ	country
bhutanilainen	NOUN	inhabitant
bihari	NOUN	language
bikol	NOUN	language
bilin	NOUN	language
bini	NOUN	language
bislama	NOUN	language
blisskieli	NOUN	language
bodo	NOUN	language
bolivialainen	ADJ	country
bolivialainen	NOUN	inhabitant
bosnia	NOUN	language
bosniahertsegovinalainen	ADJ	country
bosniahertsegovinalainen	NOUN	inhabitant
botswanalainen	ADJ	country
botswanalainen	NOUN	inhabitant
bouvet’nsaarelainen	ADJ	country
bouvet’nsaarelainen	NOUN	inhabitant
bradž	NOUN	language
brasilialainen	ADJ	country
brasilialainen	NOUN	inhabitant
brasilianportugali	NOUN	language
brazzavillenkongolainen	ADJ	country
brazzavillenkongolainen	NOUN	inhabitant
bretoni	NOUN	language
britannialainen	ADJ	country
britannialainen	NOUN	inhabitant
britannianenglanti	NOUN	language
britti	NOUN	inhabitant
brittiläinen	ADJ	country
brittiläinen	NOUN	inhabitant
brt	NOUN	measure
bruneilainen	ADJ	country
bruneilainen	NOUN	inhabitant
brändöläinen	ADJ	country
brändöläinen	NOUN	inhabitant
budjettineuvos	NOUN	title
bugi	NOUN	language
bulgaria	NOUN	language
bulgarialainen	ADJ	country
bulgarialainen	NOUN	inhabitant
bulu	NOUN	language
burjaatti	NOUN	language
burkinalainen	ADJ	country
burkinalainen	NOUN	inhabitant
burma	NOUN	language
burmalainen	ADJ	country
burmalainen	NOUN	inhabitant
burundilainen	ADJ	country
burundilainen	NOUN	inhabitant
c	NOUN	currency
cA	NOUN	measure
cBq	NOUN	measure
cC	NOUN	measure
cF	NOUN	measure
cH	NOUN	measure
cHz	NOUN	measure
cJ	NOUN	measure
cK	NOUN	measure
cN	NOUN	measure
cPa	NOUN	measure
cS	NOUN	measure
cT	NOUN	measure
cV	NOUN	measure
cW	NOUN	measure
cWb	NOUN	measure
caddo	NOUN	language
cal	NOUN	measure
cantus	NOUN	title
causa	NOUN	title
caymansaarelainen	ADJ	country
caymansaarelainen	NOUN	inhabitant
cayuga	NOUN	language
cc	NOUN	measure
ccd	NOUN	measure
cebuano	NOUN	language
cg	NOUN	measure
cherokee	NOUN	language
cheyenne	NOUN	language
chileläinen	ADJ	country
chileläinen	NOUN	inhabitant
chinook-jargon	NOUN	language
chipewyan	NOUN	language
choctaw	NOUN	language
chuuk	NOUN	language
ckat	NOUN	measure
cl	NOUN	measure
clm	NOUN	measure
clx	NOUN	measure
cm	NOUN	measure
cmol	NOUN	measure
cookinsaarelainen	ADJ	country
cookinsaarelainen	NOUN	inhabitant
costaricalainen	ADJ	country
costaricalainen	NOUN	inhabitant
crad	NOUN	measure
cree	NOUN	language
creek	NOUN	language
cs	NOUN	measure
csr	NOUN	measure
curaçaolainen	ADJ	country
curaçaolainen	NOUN	inhabitant
c°C	NOUN	measure
cΩ	NOUN	measure
d	NOUN	measure|time
dA	NOUN	measure
dB	NOUN	measure
dBq	NOUN	measure
dC	NOUN	measure
dF	NOUN	measure
dH	NOUN	measure
dHz	NOUN	measure
dJ	NOUN	measure
dK	NOUN	measure
dN	NOUN	measure
dPa	NOUN	measure
dS	NOUN	measure
dT	NOUN	measure
dV	NOUN	measure
dW	NOUN	measure
dWb	NOUN	measure
daA	NOUN	measure
daBq	NOUN	measure
daC	NOUN	measure
daF	NOUN	measure
daH	NOUN	measure
daHz	NOUN	measure
daJ	NOUN	measure
daK	NOUN	measure
daN	NOUN	measure
daPa	NOUN	measure
daS	NOUN	measure
daT	NOUN	measure
daV	NOUN	measure
daW	NOUN	measure
daWb	NOUN	measure
dacd	NOUN	measure
dag	NOUN	measure
dakat	NOUN	measure
dakota	NOUN	language
dalm	NOUN	measure
dalx	NOUN	measure
dam	NOUN	measure
damol	NOUN	measure
darad	NOUN	measure
dargi	NOUN	language
das	NOUN	measure
dasr	NOUN	measure
dazaga	NOUN	language
da°C	NOUN	measure
daΩ	NOUN	measure
dcd	NOUN	measure
delaware	NOUN	language
den	NOUN	measure
dg	NOUN	measure
dinaari	NOUN	currency
dinka	NOUN	language
dipl.arkkit.	NOUN	title
dipl.ekon.	NOUN	title
dipl.ins.	NOUN	title
dipl.kielenk.	NOUN	title
dipl.kirjeenv.	NOUN	title
dipl.kosm.	NOUN	title
dipl.urk.	NOUN	title
diplomi-insinööri	NOUN	title
diplomiarkkitehti	NOUN	title
diplomiekonomi	NOUN	title
diplomikielenkääntäjä	NOUN	title
diplomikirjeenvaihtaja	NOUN	title
diplomikosmetologi	NOUN	title
diplomiurkuri	NOUN	title
director	NOUN	title
dirhami	NOUN	currency
div.	NOUN	org
divehi	NOUN	language
dj	NOUN	title
djerma	NOUN	language
djiboutilainen	ADJ	country
djiboutilainen	NOUN	inhabitant
djula	NOUN	language
dkat	NOUN	measure
dl	NOUN	measure
dlm	NOUN	measure
dlx	NOUN	measure
dm	NOUN	measure
dmol	NOUN	measure
dogri	NOUN	language
dogrib	NOUN	language
dollari	NOUN	currency
dominicalainen	ADJ	country
dominikaanilainen	ADJ	country
dominikaanilainen	NOUN	inhabitant
dos.	NOUN	title
dosentti	NOUN	title
drad	NOUN	measure
dragsfjärdiläinen	ADJ	country
dragsfjärdiläinen	NOUN	inhabitant
drakma	NOUN	currency
dravidakieli	NOUN	language
ds	NOUN	measure
dsr	NOUN	measure
duala	NOUN	language
dzongkha	NOUN	language
d°C	NOUN	measure
dΩ	NOUN	measure
e	NOUN	currency
eKr.	NOUN	time
eV	NOUN	measure
eaa.	NOUN	time
eckeröläinen	ADJ	country
eckeröläinen	NOUN	inhabitant
ecu	NOUN	currency
ecuadorilainen	ADJ	country
ecuadorilainen	NOUN	inhabitant
edustaja	NOUN	title
efik	NOUN	language
egyptiläinen	ADJ	country
egyptiläinen	NOUN	inhabitant
ekajuk	NOUN	language
ekon.	NOUN	title
ekonomi	NOUN	title
el.lääk.	NOUN	title
elami	NOUN	language
elimäkeläinen	ADJ	country
elimäkeläinen	NOUN	inhabitant
elokuvaneuvos	NOUN	title
elsalvadorilainen	ADJ	country
elsalvadorilainen	NOUN	inhabitant
ely-keskus	NOUN	org
eläinl.	NOUN	title
eläinlääket.	NOUN	title
eläinlääkintöasessori	NOUN	title
eläinlääkintöneuvos	NOUN	title
eläinlääkäri	NOUN	title
eläk.	NOUN	title
eläkeläinen	NOUN	title
embu	NOUN	language
energianeuvos	NOUN	title
englanti	NOUN	language
enolainen	ADJ	country
enolainen	NOUN	inhabitant
enonkoskelainen	ADJ	country
enonkoskelainen	NOUN	inhabitant
enontekiöläinen	ADJ	country
enontekiöläinen	NOUN	inhabitant
erikoiseläinl.	NOUN	title
erikoiseläinlääkäri	NOUN	title
erikoishammasl.	NOUN	title
erikoishammaslääkäri	NOUN	title
erikoisl.	NOUN	title
erikoislähettiläs	NOUN	title
erikoislääkäri	NOUN	title
erikoist.	NOUN	title
eritrealainen	ADJ	country
eritrealainen	NOUN	inhabitant
erityislastentarhanopettaja	NOUN	title
erityisnuorisotyönohjaaja	NOUN	title
ersä	NOUN	language
eräjärveläinen	ADJ	country
eräjärveläinen	NOUN	inhabitant
eräneuvos	NOUN	title
escudo	NOUN	currency
esitt.	NOUN	title
esittelijä	NOUN	title
espanja	NOUN	language
espanjalainen	ADJ	country
espanjalainen	NOUN	inhabitant
espanjanespanja	NOUN	language
esperanto	NOUN	language
espoolainen	ADJ	country
espoolainen	NOUN	inhabitant
et.	NOUN	geo
etelä-ndebele	NOUN	language
eteläafrikkalainen	ADJ	country
eteläafrikkalainen	NOUN	inhabitant
eteläkorealainen	ADJ	country
eteläkorealainen	NOUN	inhabitant
eteläsaame	NOUN	language
eteläsotho	NOUN	language
eteläsudanilainen	ADJ	country
eteläsudanilainen	NOUN	inhabitant
etiopialainen	ADJ	country
etiopialainen	NOUN	inhabitant
eurajokelainen	ADJ	country
eurajokelainen	NOUN	inhabitant
euralainen	ADJ	country
euralainen	NOUN	inhabitant
euro	NOUN	currency
eurosentti	NOUN	currency
ev.	NOUN	title
ev.luutn.	NOUN	title
eversti	NOUN	title
everstiluutnantti	NOUN	title
evijärveinen	ADJ	country
evijärveinen	NOUN	inhabitant
evijärveläinen	ADJ	country
evijärveläinen	NOUN	inhabitant
evp.	NOUN	title
ewe	NOUN	language
ewondo	NOUN	language
f.	NOUN	currency
fA	NOUN	measure
fBq	NOUN	measure
fC	NOUN	measure
fF	NOUN	measure
fH	NOUN	measure
fHz	NOUN	measure
fJ	NOUN	measure
fK	NOUN	measure
fN	NOUN	measure
fPa	NOUN	measure
fS	NOUN	measure
fT	NOUN	measure
fV	NOUN	measure
fW	NOUN	measure
fWb	NOUN	measure
falklandinsaarelainen	ADJ	country
falklandinsaarelainen	NOUN	inhabitant
fang	NOUN	language
fanti	NOUN	language
farm.	NOUN	title
farmas.	NOUN	title
farmaseutti	NOUN	title
farsi	NOUN	language
fcd	NOUN	measure
fg	NOUN	measure
fidži	NOUN	language
fidžiläinen	ADJ	country
fidžiläinen	NOUN	inhabitant
fil.	NOUN	title
filipino	NOUN	language
filippiiniläinen	ADJ	country
filippiiniläinen	NOUN	inhabitant
filippiiniläiskieli	NOUN	language
finströmiläinen	ADJ	country
finströmiläinen	NOUN	inhabitant
fkat	NOUN	measure
fl	NOUN	currency
flaami	NOUN	language
flm	NOUN	measure
flx	NOUN	measure
fm	NOUN	measure
fmol	NOUN	measure
foinikia	NOUN	language
fon	NOUN	language
forintti	NOUN	currency
forssalainen	ADJ	country
forssalainen	NOUN	inhabitant
fr	NOUN	currency
frad	NOUN	measure
frangi	NOUN	currency
friisi	NOUN	language
friuli	NOUN	language
fs	NOUN	measure
fsr	NOUN	measure
ft.	NOUN	measure
fulani	NOUN	language
fut	NOUN	language
f°C	NOUN	measure
färsaarelainen	ADJ	country
färsaarelainen	NOUN	inhabitant
fääri	NOUN	language
föglöläinen	ADJ	country
föglöläinen	NOUN	inhabitant
fΩ	NOUN	measure
g	NOUN	measure
ga	NOUN	language
gabonilainen	ADJ	country
gabonilainen	NOUN	inhabitant
gaeli	NOUN	language
gajo	NOUN	language
gal	NOUN	measure
galicia	NOUN	language
gambialainen	ADJ	country
gambialainen	NOUN	inhabitant
ganda	NOUN	language
gbaja	NOUN	language
georgia	NOUN	language
georgialainen	ADJ	country
georgialainen	NOUN	inhabitant
getalainen	ADJ	country
getalainen	NOUN	inhabitant
ge’ez	NOUN	language
ghanalainen	ADJ	country
ghanalainen	NOUN	inhabitant
ghomala	NOUN	language
gibraltarilainen	ADJ	country
gibraltarilainen	NOUN	inhabitant
gon	NOUN	measure
gondi	NOUN	language
gootti	NOUN	language
gorontalo	NOUN	language
grebo	NOUN	language
grenadalainen	ADJ	country
grenadalainen	NOUN	inhabitant
gruusialainen	ADJ	country
gruusialainen	NOUN	inhabitant
grönlanti	NOUN	language
grönlantilainen	ADJ	country
grönlantilainen	NOUN	inhabitant
guadeloupelainen	ADJ	country
guadeloupelainen	NOUN	inhabitant
guamilainen	ADJ	country
guamilainen	NOUN	inhabitant
guarani	NOUN	currency|language
guatemalalainen	ADJ	country
guatemalalainen	NOUN	inhabitant
gudžarati	NOUN	language
guineabissaulainen	ADJ	country
guineabissaulainen	NOUN	inhabitant
guinealainen	ADJ	country
guinealainen	NOUN	inhabitant
guldeni	NOUN	currency
gusii	NOUN	language
guyanalainen	ADJ	country
guyanalainen	NOUN	inhabitant
gwitšin	NOUN	language
h	NOUN	time
h.c.	NOUN	title
hA	NOUN	measure
hBq	NOUN	measure
hC	NOUN	measure
hF	NOUN	measure
hH	NOUN	measure
hHz	NOUN	measure
hJ	NOUN	measure
hK	NOUN	measure
hN	NOUN	measure
hPa	NOUN	measure
hS	NOUN	measure
hT	NOUN	measure
hV	NOUN	measure
hW	NOUN	measure
hWb	NOUN	measure
ha	NOUN	measure
haapajärveläinen	ADJ	country
haapajärveläinen	NOUN	inhabitant
haapajärvinen	ADJ	country
haapajärvinen	NOUN	inhabitant
haapasaarelainen	ADJ	country
haapasaarelainen	NOUN	inhabitant
haapasaarinen	ADJ	country
haapasaarinen	NOUN	inhabitant
haapaveteläinen	ADJ	country
haapaveteläinen	NOUN	inhabitant
haapavetinen	ADJ	country
haapavetinen	NOUN	inhabitant
haida	NOUN	language
hailuotolainen	ADJ	country
hailuotolainen	NOUN	inhabitant
haiti	NOUN	language
haitilainen	ADJ	country
haitilainen	NOUN	inhabitant
halikkolainen	ADJ	country
halikkolainen	NOUN	inhabitant
hallinton.	NOUN	title
hallintonotaari	NOUN	title
hallintot.	NOUN	title
hallitusneuvos	NOUN	title
halsualainen	ADJ	country
halsualainen	NOUN	inhabitant
haminalainen	ADJ	country
haminalainen	NOUN	inhabitant
hammarlandilainen	ADJ	country
hammarlandilainen	NOUN	inhabitant
hammaslääket.	NOUN	title
hammaslääkäri	NOUN	title
hankasalmelainen	ADJ	country
hankasalmelainen	NOUN	inhabitant
hankolainen	ADJ	country
hankolainen	NOUN	inhabitant
harjavaltalainen	ADJ	country
harjavaltalainen	NOUN	inhabitant
hartolainen	ADJ	country
hartolainen	NOUN	inhabitant
hartolalainen	ADJ	country
hartolalainen	NOUN	inhabitant
hattulainen	ADJ	country
hattulainen	NOUN	inhabitant
hattulalainen	ADJ	country
hattulalainen	NOUN	inhabitant
hauholainen	ADJ	country
hauholainen	NOUN	inhabitant
haukiputaalainen	ADJ	country
haukiputaalainen	NOUN	inhabitant
haukivuorelainen	ADJ	country
haukivuorelainen	NOUN	inhabitant
hausa	NOUN	language
hausjärveläinen	ADJ	country
hausjärveläinen	NOUN	inhabitant
hausjärvinen	ADJ	country
hausjärvinen	NOUN	inhabitant
havaiji	NOUN	language
hcd	NOUN	measure
heetti	NOUN	language
heinolainen	ADJ	country
heinolainen	NOUN	inhabitant
heinolalainen	ADJ	country
heinolalainen	NOUN	inhabitant
heinäveteläinen	ADJ	country
heinäveteläinen	NOUN	inhabitant
heinävetinen	ADJ	country
heinävetinen	NOUN	inhabitant
helsinkiläinen	ADJ	country
helsinkiläinen	NOUN	inhabitant
heprea	NOUN	language
herero	NOUN	language
herra	NOUN	title
hg	NOUN	measure
hiittisläinen	ADJ	country
hiittisläinen	NOUN	inhabitant
hiligaino	NOUN	language
himankalainen	ADJ	country
himankalainen	NOUN	inhabitant
himatšali	NOUN	language
hindi	NOUN	language
hinnerjokelainen	ADJ	country
hinnerjokelainen	NOUN	inhabitant
hinnerjokinen	ADJ	country
hinnerjokinen	NOUN	inhabitant
hiri-motu	NOUN	language
hirvensalmelainen	ADJ	country
hirvensalmelainen	NOUN	inhabitant
hkat	NOUN	measure
hl	NOUN	measure
hlm	NOUN	measure
hlx	NOUN	measure
hm	NOUN	measure
hmol	NOUN	measure
hmong	NOUN	language
hoitaja	NOUN	title
hollanti	NOUN	language
hollantilainen	ADJ	country
hollantilainen	NOUN	inhabitant
hollolainen	ADJ	country
hollolainen	NOUN	inhabitant
hollolalainen	ADJ	country
hollolalainen	NOUN	inhabitant
hondurasilainen	ADJ	country
hondurasilainen	NOUN	inhabitant
hongkongilainen	ADJ	country
hongkongilainen	NOUN	inhabitant
honkajokelainen	ADJ	country
honkajokelainen	NOUN	inhabitant
honkajokinen	ADJ	country
honkajokinen	NOUN	inhabitant
honkilahtelainen	ADJ	country
honkilahtelainen	NOUN	inhabitant
houtskarilainen	ADJ	country
houtskarilainen	NOUN	inhabitant
hovimestari	NOUN	title
hovioik.	NOUN	title
hra	NOUN	title
hrad	NOUN	measure
hryvnia	NOUN	currency
hs	NOUN	measure
hsr	NOUN	measure
htkk	NOUN	measure
htv	NOUN	measure
huittislainen	ADJ	country
huittislainen	NOUN	inhabitant
humppilainen	ADJ	country
humppilainen	NOUN	inhabitant
humppilalainen	ADJ	country
humppilalainen	NOUN	inhabitant
hupa	NOUN	language
hv	NOUN	measure
hyrynsalmelainen	ADJ	country
hyrynsalmelainen	NOUN	inhabitant
hyvinkääläinen	ADJ	country
hyvinkääläinen	NOUN	inhabitant
h°C	NOUN	measure
hΩ	NOUN	measure
iban	NOUN	language
ibibio	NOUN	language
ido	NOUN	language
idžokieli	NOUN	language
igbo	NOUN	language
iiläinen	ADJ	country
iiläinen	NOUN	inhabitant
iiri	NOUN	language
iisalmelainen	ADJ	country
iisalmelainen	NOUN	inhabitant
iittiläinen	ADJ	country
iittiläinen	NOUN	inhabitant
ikaalilainen	ADJ	country
ikaalilainen	NOUN	inhabitant
ikaalislainen	ADJ	country
ikaalislainen	NOUN	inhabitant
ilmajokelainen	ADJ	country
ilmajokelainen	NOUN	inhabitant
ilmajokinen	ADJ	country
ilmajokinen	NOUN	inhabitant
ilmavE	NOUN	org
iloko	NOUN	language
ilomantsilainen	ADJ	country
ilomantsilainen	NOUN	inhabitant
imatralainen	ADJ	country
imatralainen	NOUN	inhabitant
in.	NOUN	measure
inarilainen	ADJ	country
inarilainen	NOUN	inhabitant
inarinsaame	NOUN	language
inc	NOUN	org
inc.	NOUN	org
indonesia	NOUN	language
indonesialainen	ADJ	country
indonesialainen	NOUN	inhabitant
inguuši	NOUN	language
iniöläinen	ADJ	country
iniöläinen	NOUN	inhabitant
inkoolainen	ADJ	country
inkoolainen	NOUN	inhabitant
ins.	NOUN	title
insinööri	NOUN	title
insinöörineuvos	NOUN	title
intendentti	NOUN	title
interlingua	NOUN	language
interlingue	NOUN	language
intialainen	ADJ	country
intialainen	NOUN	inhabitant
inuktitut	NOUN	language
inupiaq	NOUN	language
ip.	NOUN	time
irakilainen	ADJ	country
irakilainen	NOUN	inhabitant
iranilainen	ADJ	country
iranilainen	NOUN	inhabitant
irlantilainen	ADJ	country
irlantilainen	NOUN	inhabitant
irokeesikieli	NOUN	language
islanti	NOUN	language
islantilainen	ADJ	country
islantilainen	NOUN	inhabitant
isobritannialainen	ADJ	country
isobritannialainen	NOUN	inhabitant
isojokelainen	ADJ	country
isojokelainen	NOUN	inhabitant
isojokinen	ADJ	country
isojokinen	NOUN	inhabitant
isokyröläinen	ADJ	country
isokyröläinen	NOUN	inhabitant
israelilainen	ADJ	country
israelilainen	NOUN	inhabitant
it.	NOUN	geo
italia	NOUN	language
italialainen	ADJ	country
italialainen	NOUN	inhabitant
itäfriisi	NOUN	language
itätimorilainen	ADJ	country
itätimorilainen	NOUN	inhabitant
itävallansaksa	NOUN	language
itävaltalainen	ADJ	country
itävaltalainen	NOUN	inhabitant
jKr.	NOUN	time
jaa.	NOUN	time
jaalalainen	ADJ	country
jaalalainen	NOUN	inhabitant
jaava	NOUN	language
jakuutti	NOUN	language
jalasjärveläinen	ADJ	country
jalasjärveläinen	NOUN	inhabitant
jalasjärvinen	ADJ	country
jalasjärvinen	NOUN	inhabitant
jamaikalainen	ADJ	country
jamaikalainen	NOUN	inhabitant
janakkalainen	ADJ	country
janakkalainen	NOUN	inhabitant
janakkalalainen	ADJ	country
janakkalalainen	NOUN	inhabitant
jao	NOUN	language
japani	NOUN	language
japanilainen	ADJ	country
japanilainen	NOUN	inhabitant
japi	NOUN	language
jemeniläinen	ADJ	country
jemeniläinen	NOUN	inhabitant
jeni	NOUN	currency
jepualainen	ADJ	country
jepualainen	NOUN	inhabitant
jgo	NOUN	language
jiddiš	NOUN	language
jju	NOUN	language
jm	NOUN	measure
joensuulainen	ADJ	country
joensuulainen	NOUN	inhabitant
joht.	NOUN	title
johtaja	NOUN	title
jokioislainen	ADJ	country
jokioislainen	NOUN	inhabitant
jokioistelainen	ADJ	country
jokioistelainen	NOUN	inhabitant
jola-fonyi	NOUN	language
jomalalainen	ADJ	country
jomalalainen	NOUN	inhabitant
jordanialainen	ADJ	country
jordanialainen	NOUN	inhabitant
joroislainen	ADJ	country
joroislainen	NOUN	inhabitant
joruba	NOUN	language
joulusaarelainen	ADJ	country
joulusaarelainen	NOUN	inhabitant
joutsalainen	ADJ	country
joutsalainen	NOUN	inhabitant
joutsenolainen	ADJ	country
joutsenolainen	NOUN	inhabitant
jr.	NOUN	title
juan	NOUN	currency
juankoskelainen	ADJ	country
juankoskelainen	NOUN	inhabitant
jugoslavianmakedonialainen	ADJ	country
jugoslavianmakedonialainen	NOUN	inhabitant
junior	NOUN	title
jupikkikieli	NOUN	language
jurvalainen	ADJ	country
jurvalainen	NOUN	inhabitant
juukalainen	ADJ	country
juukalainen	NOUN	inhabitant
juupajokelainen	ADJ	country
juupajokelainen	NOUN	inhabitant
juupajokinen	ADJ	country
juupajokinen	NOUN	inhabitant
juuri	NOUN	language
juutalaisarabia	NOUN	language
juutalaisespanja	NOUN	language
juutalaispersia	NOUN	language
juvalainen	ADJ	country
juvalainen	NOUN	inhabitant
jyväskyläläinen	ADJ	country
jyväskyläläinen	NOUN	inhabitant
jämijärveläinen	ADJ	country
jämijärveläinen	NOUN	inhabitant
jämsäläinen	ADJ	country
jämsäläinen	NOUN	inhabitant
jämsänkoskelainen	ADJ	country
jämsänkoskelainen	NOUN	inhabitant
jäppiläinen	ADJ	country
jäppiläinen	NOUN	inhabitant
jäppiläläinen	ADJ	country
jäppiläläinen	NOUN	inhabitant
järjestöneuvos	NOUN	title
järvenpääläinen	ADJ	country
järvenpääläinen	NOUN	inhabitant
jäsen	NOUN	title
jääk.	NOUN	title
jääkäri	NOUN	title
k-m²	NOUN	measure
k-m³	NOUN	measure
kA	NOUN	measure
kB	NOUN	measure
kBq	NOUN	measure
kC	NOUN	measure
kF	NOUN	measure
kH	NOUN	measure
kHz	NOUN	measure
kJ	NOUN	measure
kK	NOUN	measure
kN	NOUN	measure
kPa	NOUN	measure
kS	NOUN	measure
kT	NOUN	measure
kV	NOUN	measure
kW	NOUN	measure
kWb	NOUN	measure
kWh	NOUN	measure
ka	NOUN	measure
kaakkois-	NOUN	geo
kaarinalainen	ADJ	country
kaarinalainen	NOUN	inhabitant
kaarlelalainen	ADJ	country
kaarlelalainen	NOUN	inhabitant
kaavilainen	ADJ	country
kaavilainen	NOUN	inhabitant
kabardi	NOUN	language
kabyyli	NOUN	language
kad.	NOUN	title
kadetti	NOUN	title
kajaanilainen	ADJ	country
kajaanilainen	NOUN	inhabitant
kako	NOUN	language
kakskertalainen	ADJ	country
kakskertalainen	NOUN	inhabitant
kalaallisut	NOUN	language
kalajokelainen	ADJ	country
kalajokelainen	NOUN	inhabitant
kalajokinen	ADJ	country
kalajokinen	NOUN	inhabitant
kalantilainen	ADJ	country
kalantilainen	NOUN	inhabitant
kalastusneuvos	NOUN	title
kalatalousneuvos	NOUN	title
kalenjin	NOUN	language
kalmukki	NOUN	language
kalvolainen	ADJ	country
kalvolainen	NOUN	inhabitant
kalvolalainen	ADJ	country
kalvolalainen	NOUN	inhabitant
kamarineuvos	NOUN	title
kamba	NOUN	language
kambodžalainen	ADJ	country
kambodžalainen	NOUN	inhabitant
kamerunilainen	ADJ	country
kamerunilainen	NOUN	inhabitant
kamr.	NOUN	title
kamreeri	NOUN	title
kanadalainen	ADJ	country
kanadalainen	NOUN	inhabitant
kanadanenglanti	NOUN	language
kanadanranska	NOUN	language
kand.	NOUN	title
kandidaatti	NOUN	title
kanembu	NOUN	language
kangasalalainen	ADJ	country
kangasalalainen	NOUN	inhabitant
kangaslampilainen	ADJ	country
kangaslampilainen	NOUN	inhabitant
kangasniemeläinen	ADJ	country
kangasniemeläinen	NOUN	inhabitant
kankaanpääläinen	ADJ	country
kankaanpääläinen	NOUN	inhabitant
kannada	NOUN	language
kannonkoskelainen	ADJ	country
kannonkoskelainen	NOUN	inhabitant
kannonkoskinen	ADJ	country
kannonkoskinen	NOUN	inhabitant
kannukselainen	ADJ	country
kannukselainen	NOUN	inhabitant
kannuslainen	ADJ	country
kannuslainen	NOUN	inhabitant
kansaned.	NOUN	title
kansanedustaja	NOUN	title
kanslianeuvos	NOUN	title
kantoninkiina	NOUN	language
kantt.	NOUN	title
kanttori	NOUN	title
kanuri	NOUN	language
kappal.	NOUN	title
kappalainen	NOUN	title
kapt.	NOUN	title
kapt.luutn.	NOUN	title
kapteeni	NOUN	title
kapteeniluutnantti	NOUN	title
kapverdeläinen	ADJ	country
kapverdeläinen	NOUN	inhabitant
kapverdenkreoli	NOUN	language
karakalpakki	NOUN	language
karatšai-balkaari	NOUN	language
karen	NOUN	language
karhulalainen	ADJ	country
karhulalainen	NOUN	inhabitant
karibi	NOUN	language
karijokelainen	ADJ	country
karijokelainen	NOUN	inhabitant
karinaislainen	ADJ	country
karinaislainen	NOUN	inhabitant
karinaistelainen	ADJ	country
karinaistelainen	NOUN	inhabitant
karjaalainen	ADJ	country
karjaalainen	NOUN	inhabitant
karjala	NOUN	language
karjalalainen	ADJ	country
karjalalainen	NOUN	inhabitant
karjalohjalainen	ADJ	country
karjalohjalainen	NOUN	inhabitant
karkkilainen	ADJ	country
karkkilainen	NOUN	inhabitant
karkkilalainen	ADJ	country
karkkilalainen	NOUN	inhabitant
karkkulainen	ADJ	country
karkkulainen	NOUN	inhabitant
karstulalainen	ADJ	country
karstulalainen	NOUN	inhabitant
karttulalainen	ADJ	country
karttulalainen	NOUN	inhabitant
karunalainen	ADJ	country
karunalainen	NOUN	inhabitant
karunkilainen	ADJ	country
karunkilainen	NOUN	inhabitant
karviainen	ADJ	country
karviainen	NOUN	inhabitant
karvialainen	ADJ	country
karvialainen	NOUN	inhabitant
kaskislainen	ADJ	country
kaskislainen	NOUN	inhabitant
kasvatust.	NOUN	title
katalaani	NOUN	language
katanganluba	NOUN	language
katšin	NOUN	language
kauhajokelainen	ADJ	country
kauhajokelainen	NOUN	inhabitant
kauhajokinen	ADJ	country
kauhajokinen	NOUN	inhabitant
kauhavainen	ADJ	country
kauhavainen	NOUN	inhabitant
kauhavalainen	ADJ	country
kauhavalainen	NOUN	inhabitant
kauniaislainen	ADJ	country
kauniaislainen	NOUN	inhabitant
kauppaneuvos	NOUN	title
kauppat.	NOUN	title
kauppateknikko	NOUN	title
kauppias	NOUN	title
kaupunginjohtaja	NOUN	title
kaupunkineuvos	NOUN	title
kaustislainen	ADJ	country
kaustislainen	NOUN	inhabitant
kauvatsalainen	ADJ	country
kauvatsalainen	NOUN	inhabitant
kavi	NOUN	language
kazakki	NOUN	language
kazakstanilainen	ADJ	country
kazakstanilainen	NOUN	inhabitant
kašmiri	NOUN	language
kašubi	NOUN	language
kb	NOUN	measure
kcal	NOUN	measure
kcd	NOUN	measure
kd.	NOUN	polit
keikyäläinen	ADJ	country
keikyäläinen	NOUN	inhabitant
keiteleläinen	ADJ	country
keiteleläinen	NOUN	inhabitant
kemijärveläinen	ADJ	country
kemijärveläinen	NOUN	inhabitant
kemiläinen	ADJ	country
kemiläinen	NOUN	inhabitant
keminmaalainen	ADJ	country
keminmaalainen	NOUN	inhabitant
kemisti	NOUN	title
kemiöläinen	ADJ	country
kemiöläinen	NOUN	inhabitant
kemiönsaarelainen	ADJ	country
kemiönsaarelainen	NOUN	inhabitant
kempeleläinen	ADJ	country
kempeleläinen	NOUN	inhabitant
kenialainen	ADJ	country
kenialainen	NOUN	inhabitant
kenr.	NOUN	title
kenr.luutn.	NOUN	title
kenr.maj.	NOUN	title
kenraali	NOUN	title
kenraaliluutnantti	NOUN	title
kenraalimajuri	NOUN	title
kenttäpiispa	NOUN	title
keravalainen	ADJ	country
keravalainen	NOUN	inhabitant
kerimäkeläinen	ADJ	country
kerimäkeläinen	NOUN	inhabitant
kers.	NOUN	title
kersantti	NOUN	title
kesk.	NOUN	polit|time
keski-iiri	NOUN	language
keskiafrikkalainen	ADJ	country
keskiafrikkalainen	NOUN	inhabitant
keskienglanti	NOUN	language
keskihollanti	NOUN	language
keskikhmer	NOUN	language
keskiranska	NOUN	language
keskiyläsaksa	NOUN	language
kestiläläinen	ADJ	country
kestiläläinen	NOUN	inhabitant
kesälahtelainen	ADJ	country
kesälahtelainen	NOUN	inhabitant
ketšua	NOUN	language
keuruslainen	ADJ	country
keuruslainen	NOUN	inhabitant
keuruulainen	ADJ	country
keuruulainen	NOUN	inhabitant
kg	NOUN	measure
kh	NOUN	org
khasi	NOUN	language
khmer	NOUN	language
khoisankieli	NOUN	language
khotani	NOUN	language
khra	NOUN	title
kielenkääntäjä	NOUN	title
kielitieteilijä	NOUN	title
kiga	NOUN	language
kihlakunnanneuvos	NOUN	title
kihniöläinen	ADJ	country
kihniöläinen	NOUN	inhabitant
kiihtelysvaaralainen	ADJ	country
kiihtelysvaaralainen	NOUN	inhabitant
kiikalalainen	ADJ	country
kiikalalainen	NOUN	inhabitant
kiikkalainen	ADJ	country
kiikkalainen	NOUN	inhabitant
kiikoislainen	ADJ	country
kiikoislainen	NOUN	inhabitant
kiiminkiläinen	ADJ	country
kiiminkiläinen	NOUN	inhabitant
kiina	NOUN	language
kiinalainen	ADJ	country
kiinalainen	NOUN	inhabitant
kiint.oy	NOUN	org
kiint.oy.	NOUN	org
kiinteistöneuvos	NOUN	title
kiinteistönvälittäjä	NOUN	title
kikuju	NOUN	language
killinki	NOUN	currency
kimbundu	NOUN	language
kingwana	NOUN	language
kinnulalainen	ADJ	country
kinnulalainen	NOUN	inhabitant
kinshasankongolainen	ADJ	country
kinshasankongolainen	NOUN	inhabitant
kir.	NOUN	title
kirgiisi	NOUN	language
kirgisialainen	ADJ	country
kirgisialainen	NOUN	inhabitant
kiribati	NOUN	language
kiribatilainen	ADJ	country
kiribatilainen	NOUN	inhabitant
kirjapainoneuvos	NOUN	title
kirjastoneuvos	NOUN	title
kirjeenv.	NOUN	title
kirjeenvaihtaja	NOUN	title
kirkkoherra	NOUN	title
kirkkonummelainen	ADJ	country
kirkkonummelainen	NOUN	inhabitant
kirkkoslaavi	NOUN	language
kirvesmies	NOUN	title
kiskolainen	ADJ	country
kiskolainen	NOUN	inhabitant
kiteeläinen	ADJ	country
kiteeläinen	NOUN	inhabitant
kittiläinen	ADJ	country
kittiläinen	NOUN	inhabitant
kittiläläinen	ADJ	country
kittiläläinen	NOUN	inhabitant
kiukaislainen	ADJ	country
kiukaislainen	NOUN	inhabitant
kiukaistelainen	ADJ	country
kiukaistelainen	NOUN	inhabitant
kiuruveteläinen	ADJ	country
kiuruveteläinen	NOUN	inhabitant
kiuruvetinen	ADJ	country
kiuruvetinen	NOUN	inhabitant
kivijärveläinen	ADJ	country
kivijärveläinen	NOUN	inhabitant
kivijärvinen	ADJ	country
kivijärvinen	NOUN	inhabitant
kk	NOUN	time
kkat	NOUN	measure
kkp	NOUN	measure
kl.	NOUN	time
klingon	NOUN	language
klm	NOUN	measure
klo	NOUN	time
klx	NOUN	measure
km	NOUN	measure
kmol	NOUN	measure
kodisjokelainen	ADJ	country
kodisjokelainen	NOUN	inhabitant
koijärveläinen	ADJ	country
koijärveläinen	NOUN	inhabitant
koillis-	NOUN	geo
koivulahtelainen	ADJ	country
koivulahtelainen	NOUN	inhabitant
kok.	NOUN	polit|title
kokemäkeläinen	ADJ	country
kokemäkeläinen	NOUN	inhabitant
kokkolalainen	ADJ	country
kokkolalainen	NOUN	inhabitant
kolarilainen	ADJ	country
kolarilainen	NOUN	inhabitant
koltansaame	NOUN	language
kolumbialainen	ADJ	country
kolumbialainen	NOUN	inhabitant
kom	NOUN	language
kom.	NOUN	title
kom.kapt.	NOUN	title
komentaja	NOUN	title
komentajakapteeni	NOUN	title
komi	NOUN	language
komisario	NOUN	title
komm.	NOUN	polit
komori	NOUN	language
komorilainen	ADJ	country
komorilainen	NOUN	inhabitant
koneteknikko	NOUN	title
konginkankaalainen	ADJ	country
konginkankaalainen	NOUN	inhabitant
kongo	NOUN	language
kongolainen	ADJ	country
kongolainen	NOUN	inhabitant
konkani	NOUN	language
konneveteläinen	ADJ	country
konneveteläinen	NOUN	inhabitant
konnevetinen	ADJ	country
konnevetinen	NOUN	inhabitant
konst.	NOUN	title
konstaapeli	NOUN	title
konsuli	NOUN	title
konsultti	NOUN	title
kontiolahtelainen	ADJ	country
kontiolahtelainen	NOUN	inhabitant
kookossaarelainen	ADJ	country
kookossaarelainen	NOUN	inhabitant
koose	NOUN	language
kop	NOUN	currency
kopti	NOUN	language
korea	NOUN	language
korealainen	ADJ	country
korealainen	NOUN	inhabitant
korni	NOUN	language
korpilahtelainen	ADJ	country
korpilahtelainen	NOUN	inhabitant
korpilahtinen	ADJ	country
korpilahtinen	NOUN	inhabitant
korppoolainen	ADJ	country
korppoolainen	NOUN	inhabitant
korpr.	NOUN	title
korpraali	NOUN	title
korsika	NOUN	language
korsnäsiläinen	ADJ	country
korsnäsiläinen	NOUN	inhabitant
kortesjärveläinen	ADJ	country
kortesjärveläinen	NOUN	inhabitant
kortesjärvinen	ADJ	country
kortesjärvinen	NOUN	inhabitant
koruna	NOUN	currency
koskelainen	ADJ	country
koskelainen	NOUN	inhabitant
koskenpääläinen	ADJ	country
koskenpääläinen	NOUN	inhabitant
kosmetologi	NOUN	title
kosovolainen	ADJ	country
kosovolainen	NOUN	inhabitant
kosrae	NOUN	language
kotiseutuneuvos	NOUN	title
kotital.op.	NOUN	title
kotitalousneuvos	NOUN	title
kotitalousopettaja	NOUN	title
kotiteoll.op.	NOUN	title
kotiteollisuusneuvos	NOUN	title
kotiteollisuusopettaja	NOUN	title
kotkalainen	ADJ	country
kotkalainen	NOUN	inhabitant
kouluneuvos	NOUN	title
kouluttaja	NOUN	title
kouvolainen	ADJ	country
kouvolainen	NOUN	inhabitant
kouvolalainen	ADJ	country
kouvolalainen	NOUN	inhabitant
kp	NOUN	measure
kpelle	NOUN	language
kpl	NOUN	measure
kpm	NOUN	measure
kr	NOUN	currency
krad	NOUN	measure
kreikka	NOUN	language
kreikkalainen	ADJ	country
kreikkalainen	NOUN	inhabitant
krimintataari	NOUN	language
kriminturkki	NOUN	language
krist.	NOUN	polit
kristiinalainen	ADJ	country
kristiinalainen	NOUN	inhabitant
kristiinankaupunkilainen	ADJ	country
kristiinankaupunkilainen	NOUN	inhabitant
kroatia	NOUN	language
kroatialainen	ADJ	country
kroatialainen	NOUN	inhabitant
kru-kieli	NOUN	language
kruunu	NOUN	currency
kruunupyyläinen	ADJ	country
kruunupyyläinen	NOUN	inhabitant
ks	NOUN	measure
ksr	NOUN	measure
kt	NOUN	measure
kuanjama	NOUN	language
kuhmalahtelainen	ADJ	country
kuhmalahtelainen	NOUN	inhabitant
kuhmalainen	ADJ	country
kuhmalainen	NOUN	inhabitant
kuhmoislainen	ADJ	country
kuhmoislainen	NOUN	inhabitant
kuhmolainen	ADJ	country
kuhmolainen	NOUN	inhabitant
kuivaniemeläinen	ADJ	country
kuivaniemeläinen	NOUN	inhabitant
kuljettaja	NOUN	title
kullaalainen	ADJ	country
kullaalainen	NOUN	inhabitant
kulttuurineuvos	NOUN	title
kumlingelainen	ADJ	country
kumlingelainen	NOUN	inhabitant
kumykki	NOUN	language
kuna	NOUN	currency
kunnallisneuvos	NOUN	title
kunnanjohtaja	NOUN	title
kuopiolainen	ADJ	country
kuopiolainen	NOUN	inhabitant
kuoreveteläinen	ADJ	country
kuoreveteläinen	NOUN	inhabitant
kuortanelainen	ADJ	country
kuortanelainen	NOUN	inhabitant
kurdi	NOUN	language
kurikkalainen	ADJ	country
kurikkalainen	NOUN	inhabitant
kurukh	NOUN	language
kurulainen	ADJ	country
kurulainen	NOUN	inhabitant
kustavilainen	ADJ	country
kustavilainen	NOUN	inhabitant
kutenai	NOUN	language
kuubalainen	ADJ	country
kuubalainen	NOUN	inhabitant
kuusamolainen	ADJ	country
kuusamolainen	NOUN	inhabitant
kuusankoskelainen	ADJ	country
kuusankoskelainen	NOUN	inhabitant
kuusistolainen	ADJ	country
kuusistolainen	NOUN	inhabitant
kuusjokelainen	ADJ	country
kuusjokelainen	NOUN	inhabitant
kuusjärveläinen	ADJ	country
kuusjärveläinen	NOUN	inhabitant
kuv.op.	NOUN	title
kuvaaja	NOUN	title
kuvaamataidonopettaja	NOUN	title
kuwaitilainen	ADJ	country
kuwaitilainen	NOUN	inhabitant
kwasio	NOUN	language
ky	NOUN	org
ky.	NOUN	org
kylmäkoskelainen	ADJ	country
kylmäkoskelainen	NOUN	inhabitant
kymiläinen	ADJ	country
kymiläinen	NOUN	inhabitant
kymri	NOUN	language
kyproslainen	ADJ	country
kyproslainen	NOUN	inhabitant
kyyjärveläinen	ADJ	country
kyyjärveläinen	NOUN	inhabitant
kyyjärvinen	ADJ	country
kyyjärvinen	NOUN	inhabitant
k°C	NOUN	measure
käsit.op.	NOUN	title
käsityöneuvos	NOUN	title
käsityönopettaja	NOUN	title
kääntäjä	NOUN	title
kökarilainen	ADJ	country
kölsch	NOUN	language
köyliöläinen	ADJ	country
köyliöläinen	NOUN	inhabitant
kΩ	NOUN	measure
l	NOUN	measure
l.	NOUN	geo
la	NOUN	time
laamanni	NOUN	title
laboratorioinsinööri	NOUN	title
ladino	NOUN	language
lahnda	NOUN	language
lahtelainen	ADJ	country
lahtelainen	NOUN	inhabitant
laihialainen	ADJ	country
laihialainen	NOUN	inhabitant
laitilainen	ADJ	country
laitilainen	NOUN	inhabitant
laitilalainen	ADJ	country
laitilalainen	NOUN	inhabitant
laivahuoltaja	NOUN	title
lakit.	NOUN	title
lamba	NOUN	language
lammilainen	ADJ	country
lammilainen	NOUN	inhabitant
land-dajakki-kieli	NOUN	language
lango	NOUN	language
lao	NOUN	language
laolainen	ADJ	country
laolainen	NOUN	inhabitant
laosilainen	ADJ	country
laosilainen	NOUN	inhabitant
lapinjärveläinen	ADJ	country
lapinjärveläinen	NOUN	inhabitant
lapinjärvinen	ADJ	country
lapinjärvinen	NOUN	inhabitant
lapinlahtelainen	ADJ	country
lapinlahtelainen	NOUN	inhabitant
lappajärveläinen	ADJ	country
lappajärveläinen	NOUN	inhabitant
lappajärvinen	ADJ	country
lappajärvinen	NOUN	inhabitant
lappeelainen	ADJ	country
lappeelainen	NOUN	inhabitant
lappeenrantalainen	ADJ	country
lappeenrantalainen	NOUN	inhabitant
lappilainen	ADJ	country
lappilainen	NOUN	inhabitant
lapualainen	ADJ	country
lapualainen	NOUN	inhabitant
lapväärttiläinen	ADJ	country
lapväärttiläinen	NOUN	inhabitant
lari	NOUN	currency
lastent.op.	NOUN	title
lastentarhanopettaja	NOUN	title
lati	NOUN	currency
latina	NOUN	language
latvia	NOUN	language
latvialainen	ADJ	country
latvialainen	NOUN	inhabitant
laukaalainen	ADJ	country
laukaalainen	NOUN	inhabitant
laulaja	NOUN	title
lauritsalalainen	ADJ	country
lauritsalalainen	NOUN	inhabitant
lavialainen	ADJ	country
lavialainen	NOUN	inhabitant
lehdistöneuvos	NOUN	title
leht.	NOUN	title
lehtimäkeläinen	ADJ	country
lehtimäkeläinen	NOUN	inhabitant
lehtimäkinen	ADJ	country
lehtimäkinen	NOUN	inhabitant
lehtori	NOUN	title
leikkaaja	NOUN	title
leivonmäkeläinen	ADJ	country
leivonmäkeläinen	NOUN	inhabitant
leivonmäkinen	ADJ	country
leivonmäkinen	NOUN	inhabitant
lek	NOUN	currency
lemiläinen	ADJ	country
lemiläinen	NOUN	inhabitant
lemlandilainen	ADJ	country
lemlandilainen	NOUN	inhabitant
lempääläinen	ADJ	country
lempääläinen	NOUN	inhabitant
lempääläläinen	ADJ	country
lempääläläinen	NOUN	inhabitant
lemulainen	ADJ	country
lemulainen	NOUN	inhabitant
lentokapteeni	NOUN	title
leppävirtalainen	ADJ	country
leppävirtalainen	NOUN	inhabitant
lesotholainen	ADJ	country
lesotholainen	NOUN	inhabitant
lestijärveläinen	ADJ	country
lestijärveläinen	NOUN	inhabitant
lestijärvinen	ADJ	country
lestijärvinen	NOUN	inhabitant
leu	NOUN	currency
lev	NOUN	currency
levyseppä	NOUN	title
lezgi	NOUN	language
libanonilainen	ADJ	country
libanonilainen	NOUN	inhabitant
liberialainen	ADJ	country
liberialainen	NOUN	inhabitant
libyalainen	ADJ	country
libyalainen	NOUN	inhabitant
liechtensteinilainen	ADJ	country
liechtensteinilainen	NOUN	inhabitant
lieksalainen	ADJ	country
lieksalainen	NOUN	inhabitant
lietolainen	ADJ	country
lietolainen	NOUN	inhabitant
liettua	NOUN	language
liettualainen	ADJ	country
liettualainen	NOUN	inhabitant
liikenneneuvos	NOUN	title
liikuntak.	NOUN	title
liikuntaneuvos	NOUN	title
liikuntat.	NOUN	title
liira	NOUN	currency
liljendalilainen	ADJ	country
liljendalilainen	NOUN	inhabitant
limburg	NOUN	language
liminkalainen	ADJ	country
liminkalainen	NOUN	inhabitant
lingala	NOUN	language
liperiläinen	ADJ	country
liperiläinen	NOUN	inhabitant
lis.	NOUN	title
lisensiaatti	NOUN	title
liti	NOUN	currency
lkt	NOUN	language
lkv.	NOUN	time
lky	NOUN	org
lky.	NOUN	org
ll	NOUN	org
ll.	NOUN	org
lm	NOUN	measure
lohjalainen	ADJ	country
lohjalainen	NOUN	inhabitant
lohtajalainen	ADJ	country
lohtajalainen	NOUN	inhabitant
lohtolainen	ADJ	country
lohtolainen	NOUN	inhabitant
loimaalainen	ADJ	country
loimaalainen	NOUN	inhabitant
lojban	NOUN	language
lokalahtelainen	ADJ	country
lokalahtelainen	NOUN	inhabitant
loppelainen	ADJ	country
loppelainen	NOUN	inhabitant
loppilainen	ADJ	country
loppilainen	NOUN	inhabitant
lounais-	NOUN	geo
loviisalainen	ADJ	country
loviisalainen	NOUN	inhabitant
lozi	NOUN	language
ltd.	NOUN	org
ltk	NOUN	measure
ltk.	NOUN	org
luhankalainen	ADJ	country
luhankalainen	NOUN	inhabitant
luhya	NOUN	language
luiseño	NOUN	language
luluanluba	NOUN	language
lumijokelainen	ADJ	country
lumijokelainen	NOUN	inhabitant
lumijokinen	ADJ	country
lumijokinen	NOUN	inhabitant
lumparlandilainen	ADJ	country
lumparlandilainen	NOUN	inhabitant
lunda	NOUN	language
luo	NOUN	language
luokanopettaja	NOUN	title
luonnont.	NOUN	title
luopioislainen	ADJ	country
luopioislainen	NOUN	inhabitant
luopiolainen	ADJ	country
luopiolainen	NOUN	inhabitant
luoteis-	NOUN	geo
luotolainen	ADJ	country
luotolainen	NOUN	inhabitant
luotsineuvos	NOUN	title
lusai	NOUN	language
luulajansaame	NOUN	language
luumäkeläinen	ADJ	country
luumäkeläinen	NOUN	inhabitant
luutn.	NOUN	title
luutnantti	NOUN	title
luvialainen	ADJ	country
luvialainen	NOUN	inhabitant
luxemburg	NOUN	language
luxemburgilainen	ADJ	country
luxemburgilainen	NOUN	inhabitant
lv.	NOUN	time
lx	NOUN	measure
ly	NOUN	measure
lähettiläs	NOUN	title
lähetystöneuvos	NOUN	title
lähetystösihteeri	NOUN	title
längelmäkeläinen	ADJ	country
längelmäkeläinen	NOUN	inhabitant
längelmäläinen	ADJ	country
längelmäläinen	NOUN	inhabitant
länsifriisi	NOUN	language
länsisaharalainen	ADJ	country
länsisaharalainen	NOUN	inhabitant
länt.	NOUN	geo
lääk.	NOUN	title
lääket.	NOUN	title
lääkintöneuvos	NOUN	title
lääkäri	NOUN	title
m	NOUN	measure
mA	NOUN	measure
mBq	NOUN	measure
mC	NOUN	measure
mF	NOUN	measure
mH	NOUN	measure
mHz	NOUN	measure
mJ	NOUN	measure
mK	NOUN	measure
mN	NOUN	measure
mPa	NOUN	measure
mS	NOUN	measure
mT	NOUN	measure
mV	NOUN	measure
mW	NOUN	measure
mWb	NOUN	measure
ma	NOUN	time
ma.	NOUN	title
maakuntaneuvos	NOUN	title
maalahtelainen	ADJ	country
maalahtelainen	NOUN	inhabitant
maan.	NOUN	time
maaneuvos	NOUN	title
maaninkalainen	ADJ	country
maaninkalainen	NOUN	inhabitant
maanmittausinsinööri	NOUN	title
maanmittausneuvos	NOUN	title
maanviljelijä	NOUN	title
maanviljelysneuvos	NOUN	title
maarialainen	ADJ	country
maarialainen	NOUN	inhabitant
maarianhaminalainen	ADJ	country
maarianhaminalainen	NOUN	inhabitant
maasai	NOUN	language
maat.	NOUN	title
maba	NOUN	language
macaolainen	ADJ	country
macaolainen	NOUN	inhabitant
machame	NOUN	language
madagaskarilainen	ADJ	country
madagaskarilainen	NOUN	inhabitant
madame	NOUN	title
mademoiselle	NOUN	title
madura	NOUN	language
mafa	NOUN	language
magahi	NOUN	language
maist.	NOUN	title
maisteri	NOUN	title
maithili	NOUN	language
maj.	NOUN	title
majuri	NOUN	title
makassar	NOUN	language
makedonia	NOUN	language
makedonialainen	ADJ	country
makedonialainen	NOUN	inhabitant
makonde	NOUN	language
maksamaalainen	ADJ	country
maksamaalainen	NOUN	inhabitant
makua-meetto	NOUN	language
malagassi	NOUN	language
malaiji	NOUN	language
malajalam	NOUN	language
malawilainen	ADJ	country
malawilainen	NOUN	inhabitant
malawintonga	NOUN	language
malediivilainen	ADJ	country
malediivilainen	NOUN	inhabitant
malesialainen	ADJ	country
malesialainen	NOUN	inhabitant
malilainen	ADJ	country
malilainen	NOUN	inhabitant
malta	NOUN	language
maltalainen	ADJ	country
maltalainen	NOUN	inhabitant
mandar	NOUN	language
mandingo	NOUN	language
manipuri	NOUN	language
manksi	NOUN	language
manobokieli	NOUN	language
mansaarelainen	ADJ	country
mansaarelainen	NOUN	inhabitant
mantšu	NOUN	language
maori	NOUN	language
mapudungun	NOUN	language
marathi	NOUN	language
mari	NOUN	language
markka	NOUN	currency
markkinointipäällikkö	NOUN	title
marokkolainen	ADJ	country
marokkolainen	NOUN	inhabitant
marshall	NOUN	language
marshallinsaarelainen	ADJ	country
marshallinsaarelainen	NOUN	inhabitant
martiniquelainen	ADJ	country
martiniquelainen	NOUN	inhabitant
marttilalainen	ADJ	country
marttilalainen	NOUN	inhabitant
marwari	NOUN	language
maskulainen	ADJ	country
maskulainen	NOUN	inhabitant
matemaatikko	NOUN	title
matkailuneuvos	NOUN	title
matr.	NOUN	title
matruusi	NOUN	title
mauritanialainen	ADJ	country
mauritanialainen	NOUN	inhabitant
mauritiuslainen	ADJ	country
mauritiuslainen	NOUN	inhabitant
mayakieli	NOUN	language
mayottelainen	ADJ	country
mayottelainen	NOUN	inhabitant
mbundu	NOUN	language
mcd	NOUN	measure
medumba	NOUN	language
mekaanikko	NOUN	title
meksikolainen	ADJ	country
meksikolainen	NOUN	inhabitant
melliläläinen	ADJ	country
melliläläinen	NOUN	inhabitant
mende	NOUN	language
meppi	NOUN	title
merenkulkuneuvos	NOUN	title
merijärveläinen	ADJ	country
merijärveläinen	NOUN	inhabitant
merijärvinen	ADJ	country
merijärvinen	NOUN	inhabitant
merikarvialainen	ADJ	country
merikarvialainen	NOUN	inhabitant
merimaskulainen	ADJ	country
merimaskulainen	NOUN	inhabitant
merkantti	NOUN	title
merkon.	NOUN	title
merkonomi	NOUN	title
meru	NOUN	language
messukyläläinen	ADJ	country
messukyläläinen	NOUN	inhabitant
mestari	NOUN	title
meteorologi	NOUN	title
metsämaalainen	ADJ	country
metsämaalainen	NOUN	inhabitant
metsäneuvos	NOUN	title
metsänhoit.	NOUN	title
metsänhoitaja	NOUN	title
metsät.	NOUN	title
metsätalousinsinööri	NOUN	title
metsätalousneuvos	NOUN	title
mg	NOUN	measure
mgo	NOUN	language
mhy.	NOUN	org
micmac	NOUN	language
miehikkäläinen	ADJ	country
miehikkäläinen	NOUN	inhabitant
miehikkäläläinen	ADJ	country
miehikkäläläinen	NOUN	inhabitant
mietoislainen	ADJ	country
mietoislainen	NOUN	inhabitant
mietoistelainen	ADJ	country
mietoistelainen	NOUN	inhabitant
mikkeliläinen	ADJ	country
mikkeliläinen	NOUN	inhabitant
mikronesialainen	ADJ	country
mikronesialainen	NOUN	inhabitant
min	NOUN	time|measure
minangkabau	NOUN	language
ministeri	NOUN	title
mirandeesi	NOUN	language
mister	NOUN	title
mistress	NOUN	title
mk	NOUN	currency
mkat	NOUN	measure
ml	NOUN	measure
mlk.	NOUN	geo
mlm	NOUN	measure
mlx	NOUN	measure
mm	NOUN	measure
mmHg	NOUN	measure
mmol	NOUN	measure
mohawk	NOUN	language
mokša	NOUN	language
mol	NOUN	measure
moldova	NOUN	language
moldovalainen	ADJ	country
moldovalainen	NOUN	inhabitant
mon-khmer-kieli	NOUN	language
monacolainen	ADJ	country
monacolainen	NOUN	inhabitant
mongo	NOUN	language
mongoli	NOUN	language
mongolialainen	ADJ	country
mongolialainen	NOUN	inhabitant
monsieur	NOUN	title
montenegrolainen	ADJ	country
montenegrolainen	NOUN	inhabitant
montserratilainen	ADJ	country
montserratilainen	NOUN	inhabitant
morisyen	NOUN	language
mosambikilainen	ADJ	country
mosambikilainen	NOUN	inhabitant
mossi	NOUN	language
mouhijärveläinen	ADJ	country
mouhijärveläinen	NOUN	inhabitant
mpk	NOUN	measure
mrad	NOUN	measure
ms	NOUN	measure
msr	NOUN	measure
muhokselainen	ADJ	country
muhokselainen	NOUN	inhabitant
muhoslainen	ADJ	country
muhoslainen	NOUN	inhabitant
muinaisegypti	NOUN	language
muinaisenglanti	NOUN	language
muinaisiiri	NOUN	language
muinaiskreikka	NOUN	language
muinaisnorja	NOUN	language
muinaispersia	NOUN	language
muinaisprovensaali	NOUN	language
muinaisranska	NOUN	language
muinaissyyria	NOUN	language
muinaisyläsaksa	NOUN	language
multiainen	ADJ	country
multiainen	NOUN	inhabitant
multialainen	ADJ	country
multialainen	NOUN	inhabitant
mundakieli	NOUN	language
mundang	NOUN	language
munsalalainen	ADJ	country
munsalalainen	NOUN	inhabitant
muoniolainen	ADJ	country
muoniolainen	NOUN	inhabitant
mus.	NOUN	title
mus.op.	NOUN	title
museoneuvos	NOUN	title
musices	NOUN	title
musiikinopettaja	NOUN	title
musiikkineuvos	NOUN	title
mustasaarelainen	ADJ	country
mustasaarelainen	NOUN	inhabitant
muuramelainen	ADJ	country
muuramelainen	NOUN	inhabitant
muurari	NOUN	misc
muurlalainen	ADJ	country
muurlalainen	NOUN	inhabitant
muuruveteläinen	ADJ	country
muuruveteläinen	NOUN	inhabitant
muuruvetinen	ADJ	country
muuruvetinen	NOUN	inhabitant
muusikko	NOUN	title
mv.	NOUN	title
mvs.	NOUN	org
myanmarilainen	ADJ	country
myanmarilainen	NOUN	inhabitant
myene	NOUN	language
mynämäkeläinen	ADJ	country
mynämäkeläinen	NOUN	inhabitant
myrskyläinen	ADJ	country
myrskyläinen	NOUN	inhabitant
myrskyläläinen	ADJ	country
myrskyläläinen	NOUN	inhabitant
myyjä	NOUN	title
myyntiedustaja	NOUN	title
m°C	NOUN	measure
m²	NOUN	measure
m³	NOUN	measure
mäntsäläinen	ADJ	country
mäntsäläinen	NOUN	inhabitant
mäntsäläläinen	ADJ	country
mäntsäläläinen	NOUN	inhabitant
mänttäläinen	ADJ	country
mänttäläinen	NOUN	inhabitant
mänttävilppulalainen	ADJ	country
mänttävilppulalainen	NOUN	inhabitant
mäntyharjulainen	ADJ	country
mäntyharjulainen	NOUN	inhabitant
mΩ	NOUN	measure
m€	NOUN	currency
nA	NOUN	measure
nBq	NOUN	measure
nC	NOUN	measure
nF	NOUN	measure
nH	NOUN	measure
nHz	NOUN	measure
nJ	NOUN	measure
nK	NOUN	measure
nN	NOUN	measure
nPa	NOUN	measure
nS	NOUN	measure
nT	NOUN	measure
nV	NOUN	measure
nW	NOUN	measure
nWb	NOUN	measure
naantalilainen	ADJ	country
naantalilainen	NOUN	inhabitant
nahuatlkieli	NOUN	language
nakkilalainen	ADJ	country
nakkilalainen	NOUN	inhabitant
nama	NOUN	language
namibialainen	ADJ	country
namibialainen	NOUN	inhabitant
napoli	NOUN	language
nastolainen	ADJ	country
nastolainen	NOUN	inhabitant
nastolalainen	ADJ	country
nastolalainen	NOUN	inhabitant
nauru	NOUN	language
naurulainen	ADJ	country
naurulainen	NOUN	inhabitant
nauvolainen	ADJ	country
nauvolainen	NOUN	inhabitant
navajo	NOUN	language
ncd	NOUN	measure
ndonga	NOUN	language
neiti	NOUN	title
nepali	NOUN	language
nepalilainen	ADJ	country
nepalilainen	NOUN	inhabitant
neuvos	NOUN	title
newari	NOUN	language
ng	NOUN	measure
ngambay	NOUN	language
ngiemboon	NOUN	language
nias	NOUN	language
nicaragualainen	ADJ	country
nicaragualainen	NOUN	inhabitant
nigerialainen	ADJ	country
nigerialainen	NOUN	inhabitant
nigeriläinen	ADJ	country
nigeriläinen	NOUN	inhabitant
nilsiäläinen	ADJ	country
nilsiäläinen	NOUN	inhabitant
niue	NOUN	language
niuelainen	ADJ	country
niuelainen	NOUN	inhabitant
nivalainen	ADJ	country
nivalainen	NOUN	inhabitant
nivalalainen	ADJ	country
nivalalainen	NOUN	inhabitant
njandža	NOUN	language
nkat	NOUN	measure
nlm	NOUN	measure
nlx	NOUN	measure
nm	NOUN	measure
nmol	NOUN	measure
nogai	NOUN	language
nokialainen	ADJ	country
nokialainen	NOUN	inhabitant
noormarkkulainen	ADJ	country
noormarkkulainen	NOUN	inhabitant
norfolkinsaarelainen	ADJ	country
norfolkinsaarelainen	NOUN	inhabitant
norja	NOUN	language
norjalainen	ADJ	country
norjalainen	NOUN	inhabitant
norsunluurannikkolainen	ADJ	country
norsunluurannikkolainen	NOUN	inhabitant
norsunluurannikonkoro	NOUN	language
notaari	NOUN	title
nousiaislainen	ADJ	country
nousiaislainen	NOUN	inhabitant
nrad	NOUN	measure
nrt	NOUN	measure
ns	NOUN	measure
nsr	NOUN	measure
nti	ADV	title
nuer	NOUN	language
nuijamaalainen	ADJ	country
nuijamaalainen	NOUN	inhabitant
nummelainen	ADJ	country
nummelainen	NOUN	inhabitant
nummilainen	ADJ	country
nummilainen	NOUN	inhabitant
nummipusulalainen	ADJ	country
nummipusulalainen	NOUN	inhabitant
nuorisoasiainneuvos	NOUN	title
nuorisotyönohjaaja	NOUN	title
nuorisotyöntekijä	NOUN	title
nurmekselainen	ADJ	country
nurmekselainen	NOUN	inhabitant
nurmeslainen	ADJ	country
nurmeslainen	NOUN	inhabitant
nurmijärveläinen	ADJ	country
nurmijärveläinen	NOUN	inhabitant
nurmijärvinen	ADJ	country
nurmijärvinen	NOUN	inhabitant
nurmolainen	ADJ	country
nurmolainen	NOUN	inhabitant
nyamwezi	NOUN	language
nyankole	NOUN	language
nyoro	NOUN	language
nzima	NOUN	language
n°C	NOUN	measure
närpiöläinen	ADJ	country
närpiöläinen	NOUN	inhabitant
nΩ	NOUN	measure
n’ko	NOUN	language
oa.	NOUN	title
odžibwa	NOUN	language
ohjaaja	NOUN	title
oikeust.	NOUN	title
ok.	NOUN	org
oksitaani	NOUN	language
omanilainen	ADJ	country
omanilainen	NOUN	inhabitant
op	NOUN	measure
op.	NOUN	title
opett.	NOUN	title
opettaja	NOUN	title
opetusneuvos	NOUN	title
opinto-ohjaaja	NOUN	title
opiskelija	NOUN	title
opo	NOUN	title
opp.	NOUN	title
oppilas	NOUN	title
oravaislainen	ADJ	country
oravaislainen	NOUN	inhabitant
orija	NOUN	language
orimattilainen	ADJ	country
orimattilainen	NOUN	inhabitant
orimattilalainen	ADJ	country
orimattilalainen	NOUN	inhabitant
oripääläinen	ADJ	country
oripääläinen	NOUN	inhabitant
oriveteläinen	ADJ	country
oriveteläinen	NOUN	inhabitant
oromo	NOUN	language
osage	NOUN	language
osk	NOUN	org
osk.	NOUN	org
osmani	NOUN	language
osseetti	NOUN	language
otomikieli	NOUN	language
oulaislainen	ADJ	country
oulaislainen	NOUN	inhabitant
oulaistelainen	ADJ	country
oulaistelainen	NOUN	inhabitant
oulujokelainen	ADJ	country
oulujokelainen	NOUN	inhabitant
oulujokinen	ADJ	country
oulujokinen	NOUN	inhabitant
oululainen	ADJ	country
oululainen	NOUN	inhabitant
oulunsalolainen	ADJ	country
oulunsalolainen	NOUN	inhabitant
outokumpulainen	ADJ	country
outokumpulainen	NOUN	inhabitant
ov	NOUN	measure
oy	NOUN	org
oy.	NOUN	org
oyj	NOUN	org
oyj.	NOUN	org
oz.	NOUN	measure
p	NOUN	time
p.m.	NOUN	time
pA	NOUN	measure
pBq	NOUN	measure
pC	NOUN	measure
pF	NOUN	measure
pH	NOUN	measure
pHz	NOUN	measure
pJ	NOUN	measure
pK	NOUN	measure
pN	NOUN	measure
pPa	NOUN	measure
pS	NOUN	measure
pT	NOUN	measure
pV	NOUN	measure
pW	NOUN	measure
pWb	NOUN	measure
paali	NOUN	language
paattislainen	ADJ	country
paattislainen	NOUN	inhabitant
paattistelainen	ADJ	country
paattistelainen	NOUN	inhabitant
paavolainen	ADJ	country
paavolainen	NOUN	inhabitant
paavolalainen	ADJ	country
paavolalainen	NOUN	inhabitant
padasjokelainen	ADJ	country
padasjokelainen	NOUN	inhabitant
pahlavi	NOUN	language
paimiolainen	ADJ	country
paimiolainen	NOUN	inhabitant
pak	NOUN	measure
pakistanilainen	ADJ	country
pakistanilainen	NOUN	inhabitant
pakk	NOUN	measure
palau	NOUN	language
palaulainen	ADJ	country
palaulainen	NOUN	inhabitant
palestiinalainen	ADJ	country
palestiinalainen	NOUN	inhabitant
paltamolainen	ADJ	country
paltamolainen	NOUN	inhabitant
pampanga	NOUN	language
panamalainen	ADJ	country
panamalainen	NOUN	inhabitant
pandžabi	NOUN	language
pangasinan	NOUN	language
paperikoneenhoitaja	NOUN	title
papiamentu	NOUN	language
papua-uusiguinealainen	ADJ	country
papua-uusiguinealainen	NOUN	inhabitant
papualaiskieli	NOUN	language
papuauusiguinealainen	ADJ	country
papuauusiguinealainen	NOUN	inhabitant
paraguaylainen	ADJ	country
paraguaylainen	NOUN	inhabitant
paraislainen	ADJ	country
paraislainen	NOUN	inhabitant
paraistelainen	ADJ	country
paraistelainen	NOUN	inhabitant
parikkalainen	ADJ	country
parikkalainen	NOUN	inhabitant
parikkalalainen	ADJ	country
parikkalalainen	NOUN	inhabitant
parkanolainen	ADJ	country
parkanolainen	NOUN	inhabitant
past.	NOUN	title
pastori	NOUN	title
patenttineuvos	NOUN	title
pattijokelainen	ADJ	country
pattijokelainen	NOUN	inhabitant
pattijokinen	ADJ	country
pattijokinen	NOUN	inhabitant
paštu	NOUN	language
pc	NOUN	measure
pcd	NOUN	measure
pe	NOUN	time
pedersöreläinen	ADJ	country
pedersöreläinen	NOUN	inhabitant
pelkosenniemeläinen	ADJ	country
pelkosenniemeläinen	NOUN	inhabitant
pellolainen	ADJ	country
pellolainen	NOUN	inhabitant
penni	NOUN	currency
perholainen	ADJ	country
perholainen	NOUN	inhabitant
perj.	NOUN	time
pernajalainen	ADJ	country
pernajalainen	NOUN	inhabitant
perniöläinen	ADJ	country
perniöläinen	NOUN	inhabitant
persia	NOUN	language
pertteliläinen	ADJ	country
pertteliläinen	NOUN	inhabitant
pertunmaalainen	ADJ	country
pertunmaalainen	NOUN	inhabitant
perulainen	ADJ	country
perulainen	NOUN	inhabitant
perusk.op.	NOUN	title
peruskoulunopettaja	NOUN	title
peräseinäjokelainen	ADJ	country
peräseinäjokelainen	NOUN	inhabitant
peräseinäjokinen	ADJ	country
peräseinäjokinen	NOUN	inhabitant
peseta	NOUN	currency
peso	NOUN	currency
petolahtelainen	ADJ	country
petolahtelainen	NOUN	inhabitant
petäjäveteläinen	ADJ	country
petäjäveteläinen	NOUN	inhabitant
petäjävetinen	ADJ	country
petäjävetinen	NOUN	inhabitant
pg	NOUN	measure
pidgin	NOUN	language
pieksämäkeläinen	ADJ	country
pieksämäkeläinen	NOUN	inhabitant
pielaveteläinen	ADJ	country
pielaveteläinen	NOUN	inhabitant
pielavetinen	ADJ	country
pielavetinen	NOUN	inhabitant
pielisensuulainen	ADJ	country
pielisensuulainen	NOUN	inhabitant
pielisjärveläinen	ADJ	country
pielisjärveläinen	NOUN	inhabitant
pienviljelijä	NOUN	title
pietarsaarelainen	ADJ	country
pietarsaarelainen	NOUN	inhabitant
pihlajaveteläinen	ADJ	country
pihlajaveteläinen	NOUN	inhabitant
pihlajavetinen	ADJ	country
pihlajavetinen	NOUN	inhabitant
pihtiputaalainen	ADJ	country
pihtiputaalainen	NOUN	inhabitant
piikkiöläinen	ADJ	country
piikkiöläinen	NOUN	inhabitant
piippolalainen	ADJ	country
piippolalainen	NOUN	inhabitant
piispa	NOUN	title
pion.	NOUN	title
pioneeri	NOUN	title
pirkkalainen	ADJ	country
pirkkalainen	NOUN	inhabitant
pirkkalalainen	ADJ	country
pirkkalalainen	NOUN	inhabitant
pit.	NOUN	geo
pitcairnilainen	ADJ	country
pitcairnilainen	NOUN	inhabitant
pitäjänneuvos	NOUN	title
pj	NOUN	title
pj.	NOUN	title
pk-seutu	NOUN	geo
pkat	NOUN	measure
pkt	NOUN	measure
pl	NOUN	measure
plc	NOUN	org
plm	NOUN	measure
plx	NOUN	measure
pm	NOUN	measure
pmm	NOUN	measure
pmol	NOUN	measure
pnk	NOUN	measure
pohj.	NOUN	geo
pohjalainen	ADJ	country
pohjalainen	NOUN	inhabitant
pohjanpitäjäläinen	ADJ	country
pohjanpitäjäläinen	NOUN	inhabitant
pohjaslahtelainen	ADJ	country
pohjaslahtelainen	NOUN	inhabitant
pohjaslahtinen	ADJ	country
pohjaslahtinen	NOUN	inhabitant
pohjois-ndebele	NOUN	language
pohjoisamerikkalainen	ADJ	country
pohjoisamerikkalainen	NOUN	inhabitant
pohjoisfriisi	NOUN	language
pohjoiskorealainen	ADJ	country
pohjoiskorealainen	NOUN	inhabitant
pohjoismariaanilainen	ADJ	country
pohjoismariaanilainen	NOUN	inhabitant
pohjoissaame	NOUN	language
pohjoissotho	NOUN	language
pohnpei	NOUN	language
poliisineuvos	NOUN	title
polvijärveläinen	ADJ	country
polvijärveläinen	NOUN	inhabitant
pomarkkulainen	ADJ	country
pomarkkulainen	NOUN	inhabitant
porilainen	ADJ	country
porilainen	NOUN	inhabitant
pormestari	NOUN	title
pornaislainen	ADJ	country
pornaislainen	NOUN	inhabitant
pornalainen	ADJ	country
pornalainen	NOUN	inhabitant
portugali	NOUN	language
portugalilainen	ADJ	country
portugalilainen	NOUN	inhabitant
portugalinportugali	NOUN	language
porvoolainen	ADJ	country
porvoolainen	NOUN	inhabitant
posiolainen	ADJ	country
posiolainen	NOUN	inhabitant
postimestari	NOUN	title
ppm	NOUN	measure
prad	NOUN	measure
prakritkieli	NOUN	language
presidentti	NOUN	title
prk	NOUN	measure
prof.	NOUN	title
professori	NOUN	title
prok.	NOUN	title
prokuristi	NOUN	title
prov.	NOUN	title
provensaali	NOUN	language
proviisori	NOUN	title
ps	NOUN	measure
ps.	NOUN	polit
psr	NOUN	measure
psykol.	NOUN	title
psykologi	NOUN	title
pudasjärveläinen	ADJ	country
pudasjärveläinen	NOUN	inhabitant
puertoricolainen	ADJ	country
puertoricolainen	NOUN	inhabitant
puh.joht.	NOUN	title
puheenjohtaja	NOUN	title
pukkilainen	ADJ	country
pukkilainen	NOUN	inhabitant
pukkilalainen	ADJ	country
pukkilalainen	NOUN	inhabitant
pulkkilalainen	ADJ	country
pulkkilalainen	NOUN	inhabitant
punkaharjulainen	ADJ	country
punkaharjulainen	NOUN	inhabitant
punkalaitumelainen	ADJ	country
punkalaitumelainen	NOUN	inhabitant
punta	NOUN	currency
puola	NOUN	language
puolalainen	ADJ	country
puolalainen	NOUN	inhabitant
puolankalainen	ADJ	country
puolankalainen	NOUN	inhabitant
puoluesihteeri	NOUN	title
purmolainen	ADJ	country
purmolainen	NOUN	inhabitant
pursim.	NOUN	title
pursimies	NOUN	title
pusulainen	ADJ	country
pusulainen	NOUN	inhabitant
pusulalainen	ADJ	country
pusulalainen	NOUN	inhabitant
puumalainen	ADJ	country
puumalainen	NOUN	inhabitant
puumalalainen	ADJ	country
puumalalainen	NOUN	inhabitant
puutarhaneuvos	NOUN	title
puutarhaop.	NOUN	title
puutarhaopettaja	NOUN	title
puutarhuri	NOUN	title
pv	NOUN	measure|time
pv.	NOUN	title
pyhtääläinen	ADJ	country
pyhtääläinen	NOUN	inhabitant
pyhäjokelainen	ADJ	country
pyhäjokelainen	NOUN	inhabitant
pyhäjokinen	ADJ	country
pyhäjokinen	NOUN	inhabitant
pyhäjärveläinen	ADJ	country
pyhäjärveläinen	NOUN	inhabitant
pyhäjärvinen	ADJ	country
pyhäjärvinen	NOUN	inhabitant
pyhämaalainen	ADJ	country
pyhämaalainen	NOUN	inhabitant
pyhäntäinen	ADJ	country
pyhäntäinen	NOUN	inhabitant
pyhäntäläinen	ADJ	country
pyhäntäläinen	NOUN	inhabitant
pyhärantalainen	ADJ	country
pyhärantalainen	NOUN	inhabitant
pyhäselkäläinen	ADJ	country
pyhäselkäläinen	NOUN	inhabitant
pylkönmäkeläinen	ADJ	country
pylkönmäkeläinen	NOUN	inhabitant
p°C	NOUN	measure
päiväntasaajanguinealainen	ADJ	country
päiväntasaajanguinealainen	NOUN	inhabitant
pääkonsuli	NOUN	title
pääll.	NOUN	title
päällikkö	NOUN	title
pääministeri	NOUN	title
pΩ	NOUN	measure
qatarilainen	ADJ	country
qatarilainen	NOUN	inhabitant
r	NOUN	measure
r.	NOUN	polit
r/s	NOUN	measure
raahelainen	ADJ	country
raahelainen	NOUN	inhabitant
raaseporilainen	ADJ	country
raaseporilainen	NOUN	inhabitant
rad	NOUN	measure
radiotoimittaja	NOUN	title
radžastani	NOUN	language
rahoitusneuvos	NOUN	title
raippaluotolainen	ADJ	country
raippaluotolainen	NOUN	inhabitant
raisiolainen	ADJ	country
raisiolainen	NOUN	inhabitant
rak.mest.	NOUN	title
rakennusinsinööri	NOUN	title
rakennusmestari	NOUN	title
rakennusmies	NOUN	title
rakennusneuvos	NOUN	title
randi	NOUN	currency
ranska	NOUN	language
ranskalainen	ADJ	country
ranskalainen	NOUN	inhabitant
ranskanguayanalainen	ADJ	country
ranskanguayanalainen	NOUN	inhabitant
ranskanpolynesialainen	ADJ	country
ranskanpolynesialainen	NOUN	inhabitant
rantasalmelainen	ADJ	country
rantasalmelainen	NOUN	inhabitant
rantsilalainen	ADJ	country
rantsilalainen	NOUN	inhabitant
ranualainen	ADJ	country
ranualainen	NOUN	inhabitant
rapanui	NOUN	language
rarotonga	NOUN	language
raumalainen	ADJ	country
raumalainen	NOUN	inhabitant
rautalampilainen	ADJ	country
rautalampilainen	NOUN	inhabitant
rautavaaralainen	ADJ	country
rautavaaralainen	NOUN	inhabitant
rautioinen	ADJ	country
rautioinen	NOUN	inhabitant
rautiolainen	ADJ	country
rautiolainen	NOUN	inhabitant
rautjärveläinen	ADJ	country
rautjärveläinen	NOUN	inhabitant
real	NOUN	currency
reht.	NOUN	title
rehtori	NOUN	title
reisjärveläinen	ADJ	country
reisjärveläinen	NOUN	inhabitant
reisjärvinen	ADJ	country
reisjärvinen	NOUN	inhabitant
rek.tn	NOUN	measure
renkolainen	ADJ	country
renkolainen	NOUN	inhabitant
renminbi	NOUN	currency
res.	NOUN	title
retoromaani	NOUN	language
revisioneuvos	NOUN	title
revonlahtelainen	ADJ	country
revonlahtelainen	NOUN	inhabitant
revonlahtinen	ADJ	country
revonlahtinen	NOUN	inhabitant
rial	NOUN	currency
riihimäkeläinen	ADJ	country
riihimäkeläinen	NOUN	inhabitant
riikintaaleri	NOUN	currency
riistaveteläinen	ADJ	country
riistaveteläinen	NOUN	inhabitant
riistavetinen	ADJ	country
riistavetinen	NOUN	inhabitant
rikoskomisario	NOUN	title
ristiinalainen	ADJ	country
ristiinalainen	NOUN	inhabitant
ristijärveläinen	ADJ	country
ristijärveläinen	NOUN	inhabitant
rkl	NOUN	measure
rkm.	NOUN	title
rl	NOUN	measure
romani	NOUN	language
romania	NOUN	language
romanialainen	ADJ	country
romanialainen	NOUN	inhabitant
romanikieli	NOUN	language
rombo	NOUN	language
rouva	NOUN	title
rov.	NOUN	title
rovaniemeläinen	ADJ	country
rovaniemeläinen	NOUN	inhabitant
rovasti	NOUN	title
rp.	NOUN	polit|org
rpl	NOUN	currency
rs	NOUN	measure
rsi	NOUN	measure
rt	NOUN	measure
rtg	NOUN	measure
rtg.	NOUN	measure
ruanda	NOUN	language
ruandalainen	ADJ	country
ruandalainen	NOUN	inhabitant
rundi	NOUN	language
ruokolahtelainen	ADJ	country
ruokolahtelainen	NOUN	inhabitant
ruotsalainen	ADJ	country
ruotsalainen	NOUN	inhabitant
ruotsi	NOUN	language
ruotsinpyhtääläinen	ADJ	country
ruotsinpyhtääläinen	NOUN	inhabitant
ruoveteläinen	ADJ	country
ruoveteläinen	NOUN	inhabitant
ruovetinen	ADJ	country
ruovetinen	NOUN	inhabitant
rupia	NOUN	currency
rupla	NOUN	currency
ruskolainen	ADJ	country
ruskolainen	NOUN	inhabitant
ruukkilainen	ADJ	country
ruukkilainen	NOUN	inhabitant
rva	NOUN	title
rwa	NOUN	language
ry	NOUN	org
ry.	NOUN	org
rymättyläläinen	ADJ	country
rymättyläläinen	NOUN	inhabitant
rääkkyläinen	ADJ	country
rääkkyläinen	NOUN	inhabitant
rääkkyläläinen	ADJ	country
rääkkyläläinen	NOUN	inhabitant
réunionilainen	ADJ	country
réunionilainen	NOUN	inhabitant
s	NOUN	time
saame	NOUN	language
saamelaiskieli	NOUN	language
saarelainen	ADJ	country
saarelainen	NOUN	inhabitant
saarijärveläinen	ADJ	country
saarijärveläinen	NOUN	inhabitant
saarijärvinen	ADJ	country
saarijärvinen	NOUN	inhabitant
sahalahtelainen	ADJ	country
sahalahtelainen	NOUN	inhabitant
saho	NOUN	language
saintbarthélemylainen	ADJ	country
saintbarthélemylainen	NOUN	inhabitant
sainthelenalainen	ADJ	country
sainthelenalainen	NOUN	inhabitant
saintkittsnevisläinen	ADJ	country
saintkittsnevisläinen	NOUN	inhabitant
saintlucialainen	ADJ	country
saintlucialainen	NOUN	inhabitant
saintmartinilainen	ADJ	country
saintmartinilainen	NOUN	inhabitant
sair.hoit.	NOUN	title
sairaalaneuvos	NOUN	title
sairaanh.op.	NOUN	title
sairaanhoidonopettaja	NOUN	title
sairaanhoitaja	NOUN	title
saksa	NOUN	language
saksalainen	ADJ	country
saksalainen	NOUN	inhabitant
sallalainen	ADJ	country
sallalainen	NOUN	inhabitant
saloislainen	ADJ	country
saloislainen	NOUN	inhabitant
saloistelainen	ADJ	country
saloistelainen	NOUN	inhabitant
salolainen	ADJ	country
salolainen	NOUN	inhabitant
salomonsaarelainen	ADJ	country
salomonsaarelainen	NOUN	inhabitant
saltvikilainen	ADJ	country
saltvikilainen	NOUN	inhabitant
samarianaramea	NOUN	language
sambialainen	ADJ	country
sambialainen	NOUN	inhabitant
samburu	NOUN	language
sammattilainen	ADJ	country
sammattilainen	NOUN	inhabitant
samoa	NOUN	language
samoalainen	ADJ	country
samoalainen	NOUN	inhabitant
sanctus	NOUN	title
sandawe	NOUN	language
sango	NOUN	language
sangu	NOUN	language
sanmarinolainen	ADJ	country
sanmarinolainen	NOUN	inhabitant
sanskrit	NOUN	language
santali	NOUN	language
sardi	NOUN	language
sasak	NOUN	language
sastamalalainen	ADJ	country
sastamalalainen	NOUN	inhabitant
satamaneuvos	NOUN	title
saudiarabialainen	ADJ	country
saudiarabialainen	NOUN	inhabitant
sauvolainen	ADJ	country
sauvolainen	NOUN	inhabitant
savitaipaleinen	ADJ	country
savitaipaleinen	NOUN	inhabitant
savitaipalelainen	ADJ	country
savitaipalelainen	NOUN	inhabitant
savonlinnalainen	ADJ	country
savonlinnalainen	NOUN	inhabitant
savonrantalainen	ADJ	country
savonrantalainen	NOUN	inhabitant
savukoskelainen	ADJ	country
savukoskelainen	NOUN	inhabitant
sd.	NOUN	polit
seinäjokelainen	ADJ	country
seinäjokelainen	NOUN	inhabitant
seinäjokinen	ADJ	country
seinäjokinen	NOUN	inhabitant
sekeli	NOUN	currency
selkuppi	NOUN	language
sena	NOUN	language
seneca	NOUN	language
senegalilainen	ADJ	country
senegalilainen	NOUN	inhabitant
senior	NOUN	title
sentti	NOUN	currency
seppä	NOUN	title
serbia	NOUN	language
serbialainen	ADJ	country
serbialainen	NOUN	inhabitant
serbokroaatti	NOUN	language
serer	NOUN	language
seurakuntaneuvos	NOUN	title
seychelliläinen	ADJ	country
seychelliläinen	NOUN	inhabitant
shambala	NOUN	language
shan	NOUN	language
shekeli	NOUN	currency
shillinki	NOUN	currency
sia	NOUN	org
sichuanin-yi	NOUN	language
sidamo	NOUN	language
sierraleonelainen	ADJ	country
sierraleonelainen	NOUN	inhabitant
sieviläinen	ADJ	country
sieviläinen	NOUN	inhabitant
siht.	NOUN	title
sihteeri	NOUN	title
siikaislainen	ADJ	country
siikaislainen	NOUN	inhabitant
siikajokelainen	ADJ	country
siikajokelainen	NOUN	inhabitant
siikajokinen	ADJ	country
siikajokinen	NOUN	inhabitant
siikalainen	ADJ	country
siikalainen	NOUN	inhabitant
siikalatvalainen	ADJ	country
siikalatvalainen	NOUN	inhabitant
siilinjärveläinen	ADJ	country
siilinjärveläinen	NOUN	inhabitant
siipyyläinen	ADJ	country
siipyyläinen	NOUN	inhabitant
siivooja	NOUN	title
siksika	NOUN	language
simolainen	ADJ	country
simolainen	NOUN	inhabitant
simpeleläinen	ADJ	country
simpeleläinen	NOUN	inhabitant
sindhi	NOUN	language
singaporelainen	ADJ	country
singaporelainen	NOUN	inhabitant
sinhala	NOUN	language
sintmaartenilainen	ADJ	country
sintmaartenilainen	NOUN	inhabitant
siouxkieli	NOUN	language
sipoolainen	ADJ	country
sipoolainen	NOUN	inhabitant
sippolalainen	ADJ	country
sippolalainen	NOUN	inhabitant
sisilia	NOUN	language
sit.	NOUN	polit
siuntiolainen	ADJ	country
siuntiolainen	NOUN	inhabitant
skotlanninenglanti	NOUN	language
skotti	NOUN	language
sl.	NOUN	time
slevi	NOUN	language
slovakialainen	ADJ	country
slovakialainen	NOUN	inhabitant
slovakki	NOUN	language
sloveeni	NOUN	language
slovenialainen	ADJ	country
slovenialainen	NOUN	inhabitant
snt	NOUN	currency
sodankyläläinen	ADJ	country
sodankyläläinen	NOUN	inhabitant
soga	NOUN	language
sogdi	NOUN	language
soinilainen	ADJ	country
soinilainen	NOUN	inhabitant
som	NOUN	currency
somali	NOUN	language
somalialainen	ADJ	country
somalialainen	NOUN	inhabitant
somerniemeläinen	ADJ	country
somerniemeläinen	NOUN	inhabitant
somerolainen	ADJ	country
somerolainen	NOUN	inhabitant
songhaikieli	NOUN	language
soninke	NOUN	language
sonkajärveläinen	ADJ	country
sonkajärveläinen	NOUN	inhabitant
sorani	NOUN	language
sorbi	NOUN	language
sorbikieli	NOUN	language
sos.	NOUN	polit
sos.dem.	NOUN	polit
sosiaalineuvos	NOUN	title
sosiaalipsykologi	NOUN	title
sosionomi	NOUN	title
sotakamreeri	NOUN	title
sotamies	NOUN	title
sotat.	NOUN	title
sotkamolainen	ADJ	country
sotkamolainen	NOUN	inhabitant
sottungalainen	ADJ	country
sottungalainen	NOUN	inhabitant
sr	NOUN	measure
sr.	NOUN	title
sranan	NOUN	language
srilankalainen	ADJ	country
srilankalainen	NOUN	inhabitant
srk	NOUN	org
srk.	NOUN	org
st.	NOUN	title
std	NOUN	measure
stm.	NOUN	title
sudanilainen	ADJ	country
sudanilainen	NOUN	inhabitant
sukellusneuvos	NOUN	title
sukuma	NOUN	language
sulkavainen	ADJ	country
sulkavainen	NOUN	inhabitant
sulkavalainen	ADJ	country
sulkavalainen	NOUN	inhabitant
sulvalainen	ADJ	country
sulvalainen	NOUN	inhabitant
sumeri	NOUN	language
sumiaislainen	ADJ	country
sumiaislainen	NOUN	inhabitant
sumialainen	ADJ	country
sumialainen	NOUN	inhabitant
sunda	NOUN	language
sundilainen	ADJ	country
sundilainen	NOUN	inhabitant
sunn.	NOUN	time
suodenniemeläinen	ADJ	country
suodenniemeläinen	NOUN	inhabitant
suolahtelainen	ADJ	country
suolahtelainen	NOUN	inhabitant
suomalainen	ADJ	country
suomalainen	NOUN	country
suomenniemeläinen	ADJ	country
suomenniemeläinen	NOUN	inhabitant
suomi	NOUN	language
suomusjärveläinen	ADJ	country
suomusjärveläinen	NOUN	inhabitant
suomussalmelainen	ADJ	country
suomussalmelainen	NOUN	inhabitant
suonenjokelainen	ADJ	country
suonenjokelainen	NOUN	inhabitant
suonenjokinen	ADJ	country
suonenjokinen	NOUN	inhabitant
suoniemeläinen	ADJ	country
suoniemeläinen	NOUN	inhabitant
supo	NOUN	org
surinamelainen	ADJ	country
surinamelainen	NOUN	inhabitant
susu	NOUN	language
suunnittelija	NOUN	title
svalbardjanmayenilainen	ADJ	country
svalbardjanmayenilainen	NOUN	inhabitant
sveitsiläinen	ADJ	country
sveitsiläinen	NOUN	inhabitant
sveitsinranska	NOUN	language
sveitsinsaksa	NOUN	language
sveitsinyläsaksa	NOUN	language
swahili	NOUN	language
swazi	NOUN	language
swazimaalainen	ADJ	country
swazimaalainen	NOUN	inhabitant
sysmäläinen	ADJ	country
sysmäläinen	NOUN	inhabitant
syyria	NOUN	language
syyrialainen	ADJ	country
syyrialainen	NOUN	inhabitant
syyttäjä	NOUN	title
sãotomépríncipeläinen	ADJ	country
sãotomépríncipeläinen	NOUN	inhabitant
särkisalolainen	ADJ	country
särkisalolainen	NOUN	inhabitant
säyneeläinen	ADJ	country
säyneeläinen	NOUN	inhabitant
säyneisläinen	ADJ	country
säyneisläinen	NOUN	inhabitant
säynätsaloinen	ADJ	country
säynätsaloinen	NOUN	inhabitant
säynätsalolainen	ADJ	country
säynätsalolainen	NOUN	inhabitant
t	NOUN	time|measure
taaleri	NOUN	currency
tadžikistanilainen	ADJ	country
tadžikistanilainen	NOUN	inhabitant
tadžikki	NOUN	language
tagalog	NOUN	language
tahiti	NOUN	language
taipalsaarelainen	ADJ	country
taipalsaarelainen	NOUN	inhabitant
tait.	NOUN	title
taita	NOUN	language
taiteilija	NOUN	title
taivalkoskelainen	ADJ	country
taivalkoskelainen	NOUN	inhabitant
taivalkoskinen	ADJ	country
taivalkoskinen	NOUN	inhabitant
taivassalolainen	ADJ	country
taivassalolainen	NOUN	inhabitant
taiwanilainen	ADJ	country
taiwanilainen	NOUN	inhabitant
tal.hoit.	NOUN	title
taloudenhoitaja	NOUN	title
talousneuvos	NOUN	title
taloussuunnittelija	NOUN	title
taloust.	NOUN	title
taloustirehtööri	NOUN	title
tamazight	NOUN	language
tamašek	NOUN	language
tamili	NOUN	language
tammelainen	ADJ	country
tammelainen	NOUN	inhabitant
tammelalainen	ADJ	country
tammelalainen	NOUN	inhabitant
tammisaarelainen	ADJ	country
tammisaarelainen	NOUN	inhabitant
tamperelainen	ADJ	country
tamperelainen	NOUN	inhabitant
tansanialainen	ADJ	country
tansanialainen	NOUN	inhabitant
tanska	NOUN	language
tanskalainen	ADJ	country
tanskalainen	NOUN	inhabitant
tanssija	NOUN	title
tanssit.	NOUN	title
tarjoilija	NOUN	title
taroko	NOUN	language
tarvasjokelainen	ADJ	country
tarvasjokelainen	NOUN	inhabitant
tasawaq	NOUN	language
tataari	NOUN	language
tašelhit	NOUN	language
teatt.	NOUN	title
teatterineuvos	NOUN	title
teerijärveläinen	ADJ	country
teerijärveläinen	NOUN	inhabitant
teiskolainen	ADJ	country
teiskolainen	NOUN	inhabitant
tekn.	NOUN	title
teknikko	NOUN	title
televisiotoimittaja	NOUN	title
telugu	NOUN	language
temmekseläinen	ADJ	country
temmekseläinen	NOUN	inhabitant
temmesläinen	ADJ	country
temmesläinen	NOUN	inhabitant
temne	NOUN	language
tenholalainen	ADJ	country
tenholalainen	NOUN	inhabitant
teollisuusneuvos	NOUN	title
teollisuustyöntekijä	NOUN	title
tereno	NOUN	language
terveydenh.	NOUN	title
terveydenhuoltoneuvos	NOUN	title
terveystiet.	NOUN	title
tervolainen	ADJ	country
tervolainen	NOUN	inhabitant
tervolalainen	ADJ	country
tervolalainen	NOUN	inhabitant
tetum	NOUN	language
teuvalainen	ADJ	country
teuvalainen	NOUN	inhabitant
thai	NOUN	language
thaikieli	NOUN	language
thaimaalainen	ADJ	country
thaimaalainen	NOUN	inhabitant
ti	NOUN	time
tiedemies	NOUN	title
tieteilijä	NOUN	title
tigre	NOUN	language
tigrinja	NOUN	language
tiibet	NOUN	language
tiist.	NOUN	time
tilintarkastaja	NOUN	title
tiukkalainen	ADJ	country
tiukkalainen	NOUN	inhabitant
tiv	NOUN	language
tj.	NOUN	title
tk.	NOUN	time
tl	NOUN	measure
tlingit	NOUN	language
tlk	NOUN	measure
tmi	ADV	org
tmk	NOUN	time
tn	NOUN	measure
togolainen	ADJ	country
togolainen	NOUN	inhabitant
tohmajärveläinen	ADJ	country
tohmajärveläinen	NOUN	inhabitant
toholampilainen	ADJ	country
toholampilainen	NOUN	inhabitant
toht.	NOUN	title
tohtori	NOUN	title
toijalalainen	ADJ	country
toijalalainen	NOUN	inhabitant
toim.apul.	NOUN	title
toim.joht.	NOUN	title
toim.siht.	NOUN	title
toiminnanjohtaja	NOUN	title
toiminnanohjaaja	NOUN	title
toimistoapulainen	NOUN	title
toimittaja	NOUN	title
toimitusjohtaja	NOUN	title
toimitussihteeri	NOUN	title
toivakkalainen	ADJ	country
toivakkalainen	NOUN	inhabitant
tok-pisin	NOUN	language
tokelau	NOUN	language
tokelaulainen	ADJ	country
tokelaulainen	NOUN	inhabitant
tolar	NOUN	currency
tonga	NOUN	language
tongalainen	ADJ	country
tongalainen	NOUN	inhabitant
torniolainen	ADJ	country
torniolainen	NOUN	inhabitant
torst.	NOUN	time
tottijärveläinen	ADJ	country
tottijärveläinen	NOUN	inhabitant
tri	NOUN	title
trinidadtobagolainen	ADJ	country
trinidadtobagolainen	NOUN	inhabitant
tsimši	NOUN	language
tsonga	NOUN	language
tswana	NOUN	language
tumbuka	NOUN	language
tunisialainen	ADJ	country
tunisialainen	NOUN	inhabitant
tuom.	NOUN	title
tuomari	NOUN	title
tupikieli	NOUN	language
turkki	NOUN	language
turkkilainen	ADJ	country
turkkilainen	NOUN	inhabitant
turkmeeni	NOUN	language
turkmenistanilainen	ADJ	country
turkmenistanilainen	NOUN	inhabitant
turkulainen	ADJ	country
turkulainen	NOUN	inhabitant
tus	NOUN	measure
tutkija	NOUN	title
tuulokselainen	ADJ	country
tuulokselainen	NOUN	inhabitant
tuuloslainen	ADJ	country
tuuloslainen	NOUN	inhabitant
tuupovaaralainen	ADJ	country
tuupovaaralainen	NOUN	inhabitant
tuusniemeläinen	ADJ	country
tuusniemeläinen	NOUN	inhabitant
tuusulainen	ADJ	country
tuusulainen	NOUN	inhabitant
tuusulalainen	ADJ	country
tuusulalainen	NOUN	inhabitant
tuva	NOUN	language
tuvalu	NOUN	language
tuvalulainen	ADJ	country
tuvalulainen	NOUN	inhabitant
twi	NOUN	language
ty	NOUN	measure
tyap	NOUN	language
tyrnäväläinen	ADJ	country
tyrnäväläinen	NOUN	inhabitant
tyrväntöläinen	ADJ	country
tyrväntöläinen	NOUN	inhabitant
tyrvääläinen	ADJ	country
tyrvääläinen	NOUN	inhabitant
työntekijä	NOUN	title
työsuojeluneuvos	NOUN	title
tähtitieteilijä	NOUN	title
töysäläinen	ADJ	country
töysäläinen	NOUN	inhabitant
tšadilainen	ADJ	country
tšadilainen	NOUN	inhabitant
tšadinarabia	NOUN	language
tšagatai	NOUN	language
tšamkieli	NOUN	language
tšamorro	NOUN	language
tšekinmaalainen	ADJ	country
tšekinmaalainen	NOUN	inhabitant
tšekki	NOUN	language
tšekkiläinen	ADJ	country
tšekkiläinen	NOUN	inhabitant
tšetšeeni	NOUN	language
tšibtša	NOUN	language
tšuvassi	NOUN	language
u	NOUN	measure
udmurtti	NOUN	language
ugandalainen	ADJ	country
ugandalainen	NOUN	inhabitant
ugarit	NOUN	language
uiguuri	NOUN	language
uittoneuvos	NOUN	title
ukraina	NOUN	language
ukrainalainen	ADJ	country
ukrainalainen	NOUN	inhabitant
ullavalainen	ADJ	country
ullavalainen	NOUN	inhabitant
ulvilalainen	ADJ	country
ulvilalainen	NOUN	inhabitant
unkari	NOUN	language
unkarilainen	ADJ	country
unkarilainen	NOUN	inhabitant
ups.	NOUN	title
upseeri	NOUN	title
urdu	NOUN	language
urheilija	NOUN	title
urjalainen	ADJ	country
urjalainen	NOUN	inhabitant
urjalalainen	ADJ	country
urjalalainen	NOUN	inhabitant
urk.	NOUN	title
urkuri	NOUN	title
uruguaylainen	ADJ	country
uruguaylainen	NOUN	inhabitant
uskelainen	ADJ	country
uskelainen	NOUN	inhabitant
uskelalainen	ADJ	country
uskelalainen	NOUN	inhabitant
utajärveläinen	ADJ	country
utajärveläinen	NOUN	inhabitant
utajärvinen	ADJ	country
utajärvinen	NOUN	inhabitant
utsjokelainen	ADJ	country
utsjokelainen	NOUN	inhabitant
uukuniemeläinen	ADJ	country
uukuniemeläinen	NOUN	inhabitant
uuraislainen	ADJ	country
uuraislainen	NOUN	inhabitant
uusikaarlepyyläinen	ADJ	country
uusikaarlepyyläinen	NOUN	inhabitant
uusikaledonialainen	ADJ	country
uusikaledonialainen	NOUN	inhabitant
uusikaupunkilainen	ADJ	country
uusikaupunkilainen	NOUN	inhabitant
uusiseelantilainen	ADJ	country
uusiseelantilainen	NOUN	inhabitant
uutisankkuri	NOUN	title
uzbekistanilainen	ADJ	country
uzbekistanilainen	NOUN	inhabitant
uzbekki	NOUN	language
v	NOUN	time
v.	NOUN	time
vaalalainen	ADJ	country
vaalalainen	NOUN	inhabitant
vaasalainen	ADJ	country
vaasalainen	NOUN	inhabitant
vahtolainen	ADJ	country
vahtolainen	NOUN	inhabitant
vai	NOUN	language
vakuutusneuvos	NOUN	title
valkeakoskelainen	ADJ	country
valkeakoskelainen	NOUN	inhabitant
valkealainen	ADJ	country
valkealainen	NOUN	inhabitant
valkealalainen	ADJ	country
valkealalainen	NOUN	inhabitant
valkovenäjä	NOUN	language
valkovenäläinen	ADJ	country
valkovenäläinen	NOUN	inhabitant
valloni	NOUN	language
valmentaja	NOUN	title
valtakunnanaramea	NOUN	language
valtakunnansyyttäjä	NOUN	title
valtimolainen	ADJ	country
valtimolainen	NOUN	inhabitant
valtioneuvos	NOUN	title
valtiopäiväneuvos	NOUN	title
valtiot.	NOUN	title
vammalainen	ADJ	country
vammalainen	NOUN	inhabitant
vammalalainen	ADJ	country
vammalalainen	NOUN	inhabitant
vampulainen	ADJ	country
vampulainen	NOUN	inhabitant
vampulalainen	ADJ	country
vampulalainen	NOUN	inhabitant
vanajainen	ADJ	country
vanajainen	NOUN	inhabitant
vanajalainen	ADJ	country
vanajalainen	NOUN	inhabitant
vantaalainen	ADJ	country
vantaalainen	NOUN	inhabitant
vanuatulainen	ADJ	country
vanuatulainen	NOUN	inhabitant
varakonsuli	NOUN	title
varan.	NOUN	title
varanotaari	NOUN	title
varapuheenjohtaja	NOUN	title
varat.	NOUN	title
varatuomari	NOUN	title
varkautelainen	ADJ	country
varkautelainen	NOUN	inhabitant
varpaisjärveläinen	ADJ	country
varpaisjärveläinen	NOUN	inhabitant
vas.	NOUN	polit
vatikaanilainen	ADJ	country
vatikaanilainen	NOUN	inhabitant
vatja	NOUN	language
vehkalahtelainen	ADJ	country
vehkalahtelainen	NOUN	inhabitant
vehkalahtinen	ADJ	country
vehkalahtinen	NOUN	inhabitant
vehmaalainen	ADJ	country
vehmaalainen	NOUN	inhabitant
vehmersalmelainen	ADJ	country
vehmersalmelainen	NOUN	inhabitant
velkualainen	ADJ	country
velkualainen	NOUN	inhabitant
venda	NOUN	language
venezuelalainen	ADJ	country
venezuelalainen	NOUN	inhabitant
venäjä	NOUN	language
venäläinen	ADJ	country
venäläinen	NOUN	inhabitant
verotusneuvos	NOUN	title
vesantolainen	ADJ	country
vesantolainen	NOUN	inhabitant
vesilahtelainen	ADJ	country
vesilahtelainen	NOUN	inhabitant
veteliläinen	ADJ	country
veteliläinen	NOUN	inhabitant
vht	ADV	title
vieremäläinen	ADJ	country
vieremäläinen	NOUN	inhabitant
viestintäneuvos	NOUN	title
vietnam	NOUN	language
vietnamilainen	ADJ	country
vietnamilainen	NOUN	inhabitant
vihantilainen	ADJ	country
vihantilainen	NOUN	inhabitant
vihr.	NOUN	polit
vihtiläinen	ADJ	country
vihtiläinen	NOUN	inhabitant
viialainen	ADJ	country
viialainen	NOUN	inhabitant
viialalainen	ADJ	country
viialalainen	NOUN	inhabitant
viihdetaiteilija	NOUN	title
viinikassa	NOUN	title
viitasaarelainen	ADJ	country
viitasaarelainen	NOUN	inhabitant
viitasaarinen	ADJ	country
viitasaarinen	NOUN	inhabitant
viittomakieli	NOUN	language
viljakkalainen	ADJ	country
viljakkalainen	NOUN	inhabitant
viljakkalalainen	ADJ	country
viljakkalalainen	NOUN	inhabitant
viljelijä	NOUN	title
vilppulainen	ADJ	country
vilppulainen	NOUN	inhabitant
vilppulalainen	ADJ	country
vilppulalainen	NOUN	inhabitant
vimpeliläinen	ADJ	country
vimpeliläinen	NOUN	inhabitant
vimpeläinen	ADJ	country
vimpeläinen	NOUN	inhabitant
viransijainen	NOUN	title
virk.	NOUN	title
virkailija	NOUN	title
viro	NOUN	language
virolahtelainen	ADJ	country
virolahtelainen	NOUN	inhabitant
virolainen	ADJ	country
virolainen	NOUN	inhabitant
virtasalmelainen	ADJ	country
virtasalmelainen	NOUN	inhabitant
virtolainen	ADJ	country
virtolainen	NOUN	inhabitant
vk	NOUN	time
vk.	NOUN	time
vkl	NOUN	time
voim.op.	NOUN	title
voimistelunopettaja	NOUN	title
volapük	NOUN	language
vpj	NOUN	title
vpj.	NOUN	title
vpk	NOUN	org
vrk	NOUN	time
vs.	NOUN	title
vt	NOUN	measure
vt.	NOUN	title
vunjo	NOUN	language
vuolijokelainen	ADJ	country
vuolijokelainen	NOUN	inhabitant
vuolijokinen	ADJ	country
vuolijokinen	NOUN	inhabitant
vuorineuvos	NOUN	title
vv.	NOUN	title
välittäjä	NOUN	title
vänr.	NOUN	title
vänrikki	NOUN	title
västanfjärdiläinen	ADJ	country
västanfjärdiläinen	NOUN	inhabitant
vääp.	NOUN	title
vääpeli	NOUN	title
vöyriläinen	ADJ	country
vöyriläinen	NOUN	inhabitant
wakashkieli	NOUN	language
wallisfutunalainen	ADJ	country
wallisfutunalainen	NOUN	inhabitant
walser	NOUN	language
waray	NOUN	language
washo	NOUN	language
wolaitta	NOUN	language
wolof	NOUN	language
won	NOUN	currency
xhosa	NOUN	language
yA	NOUN	measure
yBq	NOUN	measure
yC	NOUN	measure
yF	NOUN	measure
yH	NOUN	measure
yHz	NOUN	measure
yJ	NOUN	measure
yK	NOUN	measure
yN	NOUN	measure
yPa	NOUN	measure
yS	NOUN	measure
yT	NOUN	measure
yV	NOUN	measure
yW	NOUN	measure
yWb	NOUN	measure
yangben	NOUN	language
ycd	NOUN	measure
ye.ups.	NOUN	title
yemba	NOUN	language
yg	NOUN	measure
yhd.	NOUN	org
yhdyskuntasuunnittelija	NOUN	title
yhdysvaltalainen	ADJ	country
yhdysvaltalainen	NOUN	inhabitant
yhteiskuntat.	NOUN	title
ykat	NOUN	measure
yleisesikuntaupseeri	NOUN	title
yli-iiläinen	ADJ	country
yli-iiläinen	NOUN	inhabitant
yli-insinööri	NOUN	title
yli-intendentti	NOUN	title
yliagronomi	NOUN	title
yliarkkitehti	NOUN	title
ylihärmäläinen	ADJ	country
ylihärmäläinen	NOUN	inhabitant
ylik.	NOUN	title
ylikamreeri	NOUN	title
ylikersantti	NOUN	title
ylikiiminkiläinen	ADJ	country
ylikiiminkiläinen	NOUN	inhabitant
ylikonstaapeli	NOUN	title
ylil.	NOUN	title
yliluutnantti	NOUN	title
ylimarkkulainen	ADJ	country
ylimarkkulainen	NOUN	inhabitant
ylimatr.	NOUN	title
ylimatruusi	NOUN	title
ylimetsänhoitaja	NOUN	title
yliop.	NOUN	title
yliopettaja	NOUN	title
yliopp.	NOUN	title
ylioppilas	NOUN	title
ylioppilasmerkonomi	NOUN	title
ylip.	NOUN	title
ylipormestari	NOUN	title
ylipursimies	NOUN	title
ylirakennusmestari	NOUN	title
ylisosiaalineuvos	NOUN	title
ylistaroinen	ADJ	country
ylistaroinen	NOUN	inhabitant
ylistarolainen	ADJ	country
ylistarolainen	NOUN	inhabitant
ylitorniolainen	ADJ	country
ylitorniolainen	NOUN	inhabitant
yliv.	NOUN	title
ylivieskalainen	ADJ	country
ylivieskalainen	NOUN	inhabitant
ylivääpeli	NOUN	title
ylm	NOUN	measure
ylx	NOUN	measure
ylämaalainen	ADJ	country
ylämaalainen	NOUN	inhabitant
yläneläinen	ADJ	country
yläneläinen	NOUN	inhabitant
yläsorbi	NOUN	language
ylöjärveläinen	ADJ	country
ylöjärveläinen	NOUN	inhabitant
ym	NOUN	measure
ymol	NOUN	measure
yo	NOUN	title
yo.	NOUN	title
yo.merk.	NOUN	title
ypäjäläinen	ADJ	country
ypäjäläinen	NOUN	inhabitant
yrad	NOUN	measure
yrittäjä	NOUN	title
yrittäjäneuvos	NOUN	title
ys	NOUN	measure
ysr	NOUN	measure
y°C	NOUN	measure
yΩ	NOUN	measure
zA	NOUN	measure
zBq	NOUN	measure
zC	NOUN	measure
zF	NOUN	measure
zH	NOUN	measure
zHz	NOUN	measure
zJ	NOUN	measure
zK	NOUN	measure
zN	NOUN	measure
zPa	NOUN	measure
zS	NOUN	measure
zT	NOUN	measure
zV	NOUN	measure
zW	NOUN	measure
zWb	NOUN	measure
zambialainen	ADJ	country
zambialainen	NOUN	inhabitant
zandekieli	NOUN	language
zapoteekki	NOUN	language
zaza	NOUN	language
zcd	NOUN	measure
zenaga	NOUN	language
zg	NOUN	measure
zhuang	NOUN	language
zimbabwelainen	ADJ	country
zimbabwelainen	NOUN	inhabitant
zkat	NOUN	measure
zlm	NOUN	measure
zloty	NOUN	currency
zlx	NOUN	measure
zm	NOUN	measure
zmol	NOUN	measure
zrad	NOUN	measure
zs	NOUN	measure
zsr	NOUN	measure
zulu	NOUN	language
zuni	NOUN	language
z°C	NOUN	measure
zΩ	NOUN	measure
£	SYM	currency
£C	NOUN	currency
¥	SYM	currency
µm	NOUN	measure
Å	NOUN	measure
Ågot	PROPN	female
Åke	PROPN	male
Åland	PROPN	media
Åsa	PROPN	female
Öjvind	PROPN	male
Örjan	PROPN	male
Östen	PROPN	male
äyri	NOUN	currency
š	NOUN	currency
šillinki	NOUN	currency
šona	NOUN	language
Ω	NOUN	measure
μA	NOUN	measure
μBq	NOUN	measure
μC	NOUN	measure
μF	NOUN	measure
μH	NOUN	measure
μHz	NOUN	measure
μJ	NOUN	measure
μK	NOUN	measure
μN	NOUN	measure
μPa	NOUN	measure
μS	NOUN	measure
μT	NOUN	measure
μV	NOUN	measure
μW	NOUN	measure
μWb	NOUN	measure
μcd	NOUN	measure
μg	NOUN	measure
μkat	NOUN	measure
μlm	NOUN	measure
μlx	NOUN	measure
μm	NOUN	measure
μmol	NOUN	measure
μrad	NOUN	measure
μs	NOUN	measure
μsr	NOUN	measure
μ°C	NOUN	measure
μΩ	NOUN	measure
₤	SYM	currency
€	SYM	currency
